,Unnamed: 0,Date,Open,High,Low,Close,Adj Close,Volume,SMA14,RSI,On Balance Volume,subjectivity,polarity
14,14,2016-08-21,581.939026,584.15802,580.2180179999998,581.307983,581.307983,38299400.0,581.03901,45.50258031198997,-234433596.0,0.45068037790096616,0.08787006267153327
15,15,2016-08-22,581.310974,588.4479980000001,580.5939940000002,586.7529910000002,586.7529910000002,72844000.0,580.7317939285714,53.05230156785346,-161589596.0,0.40909449404761905,0.08967981150793651
16,16,2016-08-23,586.770996,589.473999,581.633972,583.414978,583.414978,85349200.0,580.4185048571429,48.60674912270487,-246938796.0,0.4339965030369867,0.0920466955147532
17,17,2016-08-24,583.4119870000002,583.590027,579.85498,580.182007,580.182007,56328200.0,579.5670034285715,44.69990091877902,-303266996.0,0.40561988020031503,0.11728950164167555
18,18,2016-08-25,580.179993,580.4509889999998,575.1669919999998,577.760986,577.760986,136130000.0,578.7556456428573,41.97881904491683,-439396996.0,0.5028134892978644,0.19425248198685702
19,19,2016-08-26,577.7529910000002,580.6229860000002,576.857971,579.651001,579.651001,48856800.0,578.1907870714286,44.803676748507435,-390540196.0,0.41411984875012664,0.08375819271450666
20,20,2016-08-27,579.4520259999998,579.844971,568.630005,569.947021,569.947021,59698300.0,577.073573357143,35.300648489074256,-450238496.0,0.34544489294489295,0.09790980915980917
21,21,2016-08-28,569.830017,574.038025,569.73999,573.9119870000002,573.9119870000002,86301600.0,577.3192137142859,40.823599239897526,-363936896.0,0.467630772005772,0.11233585858585858
22,22,2016-08-29,574.070984,576.278015,573.465027,574.106995,574.106995,110398000.0,577.8097140714287,41.089952648346056,-253538896.0,0.4446402002998737,0.09319586362815635
23,23,2016-08-30,574.114014,578.356995,574.114014,577.5029910000002,577.5029910000002,70342400.0,577.814283,45.67563332060604,-183196496.0,0.4391359938833201,0.12418592533432107
24,24,2016-08-31,577.591003,577.861023,573.642029,575.471985,575.471985,75840896.0,577.9754245714288,43.49500072603121,-259037392.0,0.438881973346579,0.11707536329944164
25,25,2016-09-01,575.546021,576.310974,571.814026,572.302979,572.302979,76923400.0,577.8314950000001,40.26486544019422,-335960792.0,0.5016722043271271,0.1840108108925099
26,26,2016-09-02,572.409973,575.643005,570.810974,575.5369870000002,575.5369870000002,79910800.0,577.824850857143,44.77241138918878,-256049992.0,0.40873923923923916,0.13832772057772058
27,27,2016-09-03,575.554993,599.5,574.05603,598.211975,598.211975,159014000.0,579.0044904285717,64.81807899611836,-97035992.0,0.37472478606853604,0.09048101303199989
28,28,2016-09-04,598.590027,611.836975,596.848022,608.633972,608.633972,97942896.0,580.9563467857145,70.17623624907749,906904.0,0.43682787151003466,0.08745295870058678
29,29,2016-09-05,608.98999,609.054993,602.242004,606.590027,606.590027,82446800.0,582.3732779285715,67.98928391188173,-81539896.0,0.3809729933318516,0.0952810778465247
30,30,2016-09-06,606.5059809999998,610.830017,605.091003,610.435974,610.435974,78529104.0,584.3033490714288,69.89066505310761,-3010792.0,0.4577525147002682,0.13002988906518295
31,31,2016-09-07,610.5729980000001,614.544983,608.513,614.544006,614.544006,75032400.0,586.7577775714287,71.81635415109994,72021608.0,0.4042908715837179,0.11229368761743634
32,32,2016-09-08,614.63501,628.77002,613.8439940000002,626.315979,626.315979,86713000.0,590.225991357143,76.46207674925036,158734608.0,0.46919496010811806,0.16547162233478024
33,33,2016-09-09,626.35199,626.830017,620.263,622.861023,622.861023,64550200.0,593.3124215,72.67570458398575,94184408.0,0.49085150634825814,0.11614427862432224
34,34,2016-09-10,622.9270019999999,625.094971,622.39502,623.508972,623.508972,45016800.0,597.1382751428573,72.94627929172881,139201208.0,0.45411160000874207,0.1053614200345756
35,35,2016-09-11,623.4240110000002,628.817993,600.5059809999998,606.7189940000002,606.7189940000002,73610800.0,599.4816327857144,57.153030525604564,65590408.0,0.4182532185859073,0.09486591489924884
36,36,2016-09-12,607.005005,608.458984,605.411011,608.242981,608.242981,72812304.0,601.9199175000001,58.04102251076392,138402712.0,0.445638570750881,0.09625487278244631
37,37,2016-09-13,608.025024,611.192993,606.924988,609.241028,609.241028,86920600.0,604.1869201428573,58.64548078446996,225323312.0,0.4044344771197077,0.11273519591849523
38,38,2016-09-14,608.841003,611.9520259999998,608.409973,610.684021,610.684021,47877700.0,606.7020655714288,59.55273399892891,273201012.0,0.47682816975489395,0.16379539107125313
39,39,2016-09-15,610.5880129999998,611.085999,607.155029,607.155029,607.155029,59464600.0,609.1914977142859,56.29974141973485,213736412.0,0.4759147086466165,0.10114554615705933
40,40,2016-09-16,607.2459719999998,609.260986,606.7349849999998,606.973022,606.973022,64963400.0,611.4369287857145,56.12944941768785,148773012.0,0.4715642286092625,0.09026391949149269
41,41,2016-09-17,607.2180179999998,607.8599849999998,605.192017,605.984009,605.984009,37140300.0,611.9920740714288,55.15320801587117,111632712.0,0.47509297316440174,0.06869421847993278
42,42,2016-09-18,606.28302,610.15802,605.856018,609.8740230000002,609.8740230000002,48679400.0,612.0806491428574,58.23043966940347,160312112.0,0.4814441726574079,0.12281417112299464
43,43,2016-09-19,609.8709719999998,610.932007,608.27002,609.22699,609.22699,54796400.0,612.2690036428572,57.5234168452206,105515712.0,0.45431252416166207,0.12382470831683726
44,44,2016-09-20,609.2540280000002,609.525024,607.937988,608.312012,608.312012,72710896.0,612.1172920714288,56.479081695213004,32804816.0,0.4504988876863877,0.06350556510482981
45,45,2016-09-21,603.5880129999998,603.5880129999998,595.882996,597.148987,597.148987,82776200.0,610.874790714286,45.601541975885716,-49971384.0,0.4414685467416494,0.130870172225025
46,46,2016-09-22,597.278992,598.487,596.2130129999998,596.2979740000002,596.2979740000002,67085300.0,608.7306475000003,44.891721872901726,-117056684.0,0.42629156351474745,0.09629276459455083
47,47,2016-09-23,596.198975,603.205017,595.786011,602.84198,602.84198,51067000.0,607.300715857143,51.18419539209612,-65989684.0,0.44441468081468083,0.08128289848289848
48,48,2016-09-24,602.960999,604.580017,602.044983,602.625,602.625,35359500.0,605.8090035714288,50.976353055407714,-101349184.0,0.4050282921810699,0.09768016975308642
49,49,2016-09-25,602.7490230000002,603.3809809999998,599.710999,600.8259889999998,600.8259889999998,33977800.0,605.3880746428573,49.19275068632926,-135326984.0,0.49305256290550403,0.11872979961215256
50,50,2016-09-26,600.807007,608.143005,600.348999,608.0430299999998,608.0430299999998,59153800.0,605.3737924285717,55.86433515049034,-76173184.0,0.3715915864140484,0.07893858900220317
51,51,2016-09-27,608.021973,608.2479860000002,604.1099849999998,606.166016,606.166016,49422400.0,605.154148714286,53.882603259651404,-125595584.0,0.443812848477893,0.06061349431065784
52,52,2016-09-28,606.242981,606.590027,604.606995,604.728027,604.728027,48722600.0,604.7287205714288,52.35044585660015,-174318184.0,0.4703553900424904,0.13620365718751265
53,53,2016-09-29,605.018982,606.823975,604.848022,605.692993,605.692993,55658600.0,604.6242894285716,53.30989248072702,-118659584.0,0.4271847205373992,0.10866550171460887
54,54,2016-09-30,605.715027,609.7349849999998,604.142029,609.7349849999998,609.7349849999998,56122400.0,604.8215725000001,57.19763804509707,-62537184.0,0.44470727523882325,0.1156475891910595
55,55,2016-10-01,609.929016,615.237,609.929016,613.982971,613.982971,56357000.0,605.3929269285716,60.88401344471014,-6180184.0,0.41159687410406,0.12744427186623045
56,56,2016-10-02,613.9479980000001,614.005005,609.682007,610.892029,610.892029,39249800.0,605.4656416428572,57.0348646342914,-45429984.0,0.46242167643063015,0.13620962370247777
57,57,2016-10-03,610.9680179999998,612.567993,610.455017,612.132996,612.132996,46798300.0,605.6732135000002,58.17805797088541,1368316.0,0.4616841804297693,0.1553481718159374
58,58,2016-10-04,612.0520019999999,612.054016,609.479004,610.203979,610.203979,49801600.0,605.8083540000001,55.6972247907825,-48433284.0,0.37428446211138267,0.11605468601878668
59,59,2016-10-05,610.2180179999998,613.814026,609.617004,612.510986,612.510986,68077504.0,606.9056396428573,58.003690539280434,19644220.0,0.42468567765223364,0.10241663273518112
60,60,2016-10-06,612.469971,613.81897,611.4689940000002,613.020996,613.020996,56812100.0,608.1001412142857,58.51784294435247,76456320.0,0.46249323738819553,0.11773709045907925
61,61,2016-10-07,612.607971,617.9119870000002,611.820984,617.1209719999998,617.1209719999998,64071400.0,609.1200692142859,62.493215902622225,140527720.0,0.48187700476693013,0.17026983925845224
62,62,2016-10-08,617.341003,619.848999,617.341003,619.107971,619.107971,42345900.0,610.2974242857143,64.27983127638845,182873620.0,0.43279634492476116,0.18179996498555
63,63,2016-10-09,619.1719969999998,619.1979980000001,616.606995,616.7520139999998,616.7520139999998,39243400.0,611.4349975000002,60.59424156697414,143630220.0,0.5514775364336767,0.1561279935950989
64,64,2016-10-10,616.822021,621.317993,616.197021,618.9940190000002,618.9940190000002,67481104.0,612.2172110000001,62.78123803585924,211111324.0,0.42436611503575794,0.08324829931972791
65,65,2016-10-11,619.237976,642.080017,618.5,641.072021,641.072021,103590000.0,614.7104970714288,76.57086506073308,314701324.0,0.4566982443482443,0.1273844747073914
66,66,2016-10-12,640.8709719999998,641.336975,635.965027,636.192017,636.192017,92370200.0,616.9579249285716,70.365130605516,222331124.0,0.42251900446166085,0.14482047984321653
67,67,2016-10-13,636.030029,638.8330080000002,635.028992,636.786011,636.786011,61620700.0,619.1788547857143,70.67665333030088,283951824.0,0.42922280187708034,0.1161601502498124
68,68,2016-10-14,637.007996,641.284973,637.007996,640.3779910000002,640.3779910000002,58144600.0,621.3676409285716,72.55544831089726,342096424.0,0.45168087051852174,0.14310175871674727
69,69,2016-10-15,640.310974,642.10199,637.3900150000002,638.645996,638.645996,39035400.0,623.1292855714288,70.21919926687697,303061024.0,0.43496831554854565,0.1135955345070275
70,70,2016-10-16,639.0830080000002,642.89801,638.901001,641.6309809999998,641.6309809999998,40298100.0,625.3249250000001,71.89861068274416,343359124.0,0.4991499822602308,0.13180919018962492
71,71,2016-10-17,641.817993,642.3280030000002,638.663025,639.192993,639.192993,58063600.0,627.2577819285716,68.50086492142083,285295524.0,0.42157871862195173,0.16261990202779675
72,72,2016-10-18,639.411011,640.736023,635.9959719999998,637.960022,637.960022,65546700.0,629.2403564285714,66.78202301518526,219748824.0,0.462225450946308,0.12068789792174613
73,73,2016-10-19,638.133972,638.8740230000002,628.013,630.52002,630.52002,69381696.0,630.5267160000002,57.41929128286353,150367128.0,0.365561127860235,0.11561103702844774
74,74,2016-10-20,630.663025,631.9169919999998,628.257996,630.856995,630.856995,56957300.0,631.8007159285718,57.708496052755535,207324428.0,0.42333057179148087,0.09811204851727429
75,75,2016-10-21,630.825012,634.0939940000002,630.69397,632.8280030000002,632.8280030000002,55951000.0,632.922646714286,59.443607104591166,263275428.0,0.3996328330538858,0.12530838070311756
76,76,2016-10-22,633.135986,658.197021,632.849976,657.294006,657.294006,78556496.0,635.6502206428573,73.80831729333515,341831924.0,0.4628706853111615,0.12534344293272867
77,77,2016-10-23,657.6209719999998,661.1290280000002,653.885986,657.070984,657.070984,54474600.0,638.5301470714287,73.5525736868008,287357324.0,0.3786077235772357,0.09884097948122339
78,79,2016-10-25,654.0020139999998,664.4240110000002,653.6979980000001,657.5880129999998,657.5880129999998,90378800.0,642.1932155714287,71.55167054863955,315517924.0,0.4095334295334296,0.0982103155515854
79,80,2016-10-26,657.677979,679.728027,657.677979,678.304016,678.304016,88877104.0,645.2012155000002,79.04407616896025,404395028.0,0.4251155146294035,0.07463157983991317
80,81,2016-10-27,678.213989,688.5939940000002,678.039978,688.312988,688.312988,96105296.0,648.8817138571433,81.56968180450541,500500324.0,0.45096322016460905,0.10149562757201647
81,82,2016-10-28,688.0,690.44397,684.1619870000002,689.651001,689.651001,81145504.0,652.4012145714289,81.88400502130546,581645828.0,0.400599111343601,0.10126704795119747
82,83,2016-10-29,690.289001,720.401978,690.0520019999999,714.479004,714.479004,134760992.0,657.8178580000006,86.4887477348465,716406820.0,0.4190938024261195,0.07316340011614403
83,84,2016-10-30,714.117981,714.117981,696.474976,701.864014,701.864014,100665000.0,662.1202175000005,75.928421096279,615741820.0,0.4304821063865973,0.10645528125445898
84,85,2016-10-31,702.6400150000002,709.289001,691.682007,700.971985,700.971985,97064400.0,666.5330026428576,75.22893449570056,518677420.0,0.4242462634901183,0.12905693280572553
85,86,2016-11-01,701.336975,736.4520259999998,701.336975,729.7930299999998,729.7930299999998,130527000.0,673.0925032142862,81.24180142781114,649204420.0,0.44134602813608903,0.0947217956757764
86,87,2016-11-02,730.065979,740.828979,722.348999,740.828979,740.828979,84865200.0,680.9717145714292,82.94859757515661,734069620.0,0.4129993192484887,0.1138917485246389
87,88,2016-11-03,742.346008,745.77301,678.1560059999998,688.700012,688.700012,172808000.0,685.1033586428576,56.70323903676361,561261620.0,0.40426156456981427,0.11237043895534878
88,89,2016-11-04,689.1240230000002,706.929993,685.562988,703.2349849999998,703.2349849999998,99907696.0,690.1324287857148,60.45989223867405,661169316.0,0.4065798093116389,0.08924023268075362
89,90,2016-11-05,703.525024,707.51001,697.739014,703.4180299999998,703.4180299999998,53752300.0,693.4270019285719,60.50636528334292,714921616.0,0.41569907310750387,0.1189274273609312
90,91,2016-11-06,703.812012,714.257996,699.5599980000002,711.521973,711.521973,59902200.0,697.3163582857147,62.60208801203717,774823816.0,0.44483535728740337,0.17125461625141933
91,92,2016-11-07,710.736023,710.736023,699.903015,703.1309809999998,703.1309809999998,65047100.0,700.8427865000006,59.1048024021275,709776716.0,0.509242078625582,0.11404144804867591
92,93,2016-11-08,703.088989,712.987,702.3900150000002,709.848022,709.848022,79660800.0,704.5756442857147,60.98384293572198,789437516.0,0.4201098433879046,0.12763011329656737
93,94,2016-11-09,709.825012,740.046021,708.6099849999998,723.27301,723.27301,132429000.0,707.7877152857149,64.49517427900864,921866516.0,0.40536557067271356,0.12631763038548752
94,95,2016-11-10,722.8439940000002,723.018005,711.210022,715.533997,715.533997,68807800.0,709.7320730714293,61.08245802524427,853058716.0,0.41809886182085165,0.11340433470241165
95,96,2016-11-11,715.554993,718.317993,714.409973,716.411011,716.411011,63119700.0,711.6435023571436,61.332163730160296,916178416.0,0.44032788926446126,0.12880331495378858
96,97,2016-11-12,716.7520139999998,717.14801,704.034973,705.054016,705.054016,64622500.0,710.9702889285719,56.29491046957572,851555916.0,0.42181858313554743,0.09956755572827002
97,98,2016-11-13,705.195984,705.257019,687.3150019999998,702.0310059999998,702.0310059999998,80318096.0,710.9822169285719,55.000031227207224,771237820.0,0.5390531994047619,0.17954179067460319
98,99,2016-11-14,701.9970089999998,706.283997,699.807983,705.020996,705.020996,62993000.0,711.2714320000005,56.07618667537408,834230820.0,0.45093607170664624,0.10824864849321372
99,100,2016-11-15,705.794006,715.7180179999998,705.26001,711.6190190000002,711.6190190000002,72038496.0,709.9732883571432,58.43821839214819,906269316.0,0.47692661641749845,0.17372736207115377
100,101,2016-11-16,711.1669919999998,747.61499,709.039001,744.1979980000001,744.1979980000001,141294000.0,710.2139325714288,67.68015996109469,1047563316.0,0.43776354805010353,0.11147611478795177
101,102,2016-11-17,744.8759769999998,755.64502,739.510986,740.97699,740.97699,108579000.0,713.9480024285717,66.11482624230976,938984316.0,0.44760003756928085,0.15331991703928285
102,103,2016-11-18,740.705017,752.882019,736.8900150000002,751.585022,751.585022,87363104.0,717.4015765000003,68.68370518020204,1026347420.0,0.4358983228139197,0.09007227947046625
103,104,2016-11-19,751.8330080000002,756.237,744.46698,751.616028,751.616028,110608000.0,720.8442906428575,68.69117648190951,1136955420.0,0.4681643819143819,0.14666396103896107
104,105,2016-11-20,751.8790280000002,755.47998,717.94397,731.026001,731.026001,154116000.0,722.2374355000003,58.67947330396471,982839420.0,0.33231256441970725,0.09803633271490417
105,106,2016-11-21,731.2650150000002,741.721985,730.51001,739.2479860000002,739.2479860000002,60802400.0,724.8172215714287,61.11658724290922,1043641820.0,0.4262325902799542,0.11485598133338988
106,107,2016-11-22,739.643005,753.869995,736.526978,751.346985,751.346985,129906000.0,727.781433214286,64.44031423175124,1173547820.0,0.3992590755082146,0.12229218720377354
107,108,2016-11-23,751.741028,752.25,738.9240110000002,744.5939940000002,744.5939940000002,76543800.0,729.3043606428573,61.29118557704094,1097004020.0,0.4121107415874059,0.1541471900834866
108,109,2016-11-24,744.619995,746.8319700000002,733.48999,740.289001,740.289001,85919296.0,731.0725752142861,59.301611066175006,1011084724.0,0.4421303872384003,0.1139962675934922
109,110,2016-11-25,740.442017,741.648987,734.591003,741.648987,741.648987,67807600.0,732.8752877857146,59.74615655847075,1078892324.0,0.4388375959601347,0.11544317194692841
110,111,2016-11-26,741.510986,742.213989,729.625,735.382019,735.382019,54962700.0,735.0415737142861,56.674085634216006,1023929624.0,0.39078790244364014,0.12661792334786293
111,112,2016-11-27,735.437012,739.018005,731.085022,732.034973,732.034973,52601800.0,737.184714214286,55.04615046482304,971327824.0,0.3521295371295372,0.12306748806748807
112,113,2016-11-28,732.484009,738.0059809999998,732.484009,735.812988,735.812988,61888600.0,739.384142214286,56.56285348459675,1033216424.0,0.3605184142622566,0.09998116056767536
113,114,2016-11-29,736.328979,737.471008,734.559021,735.604004,735.604004,68511104.0,741.097355428572,56.44939760204443,964705320.0,0.3858226372043281,0.1159296713910769
114,115,2016-11-30,736.283997,747.929016,736.2650150000002,745.690979,745.690979,84070800.0,741.2039969285719,60.56136938005073,1048776120.0,0.4482748252911296,0.09709422232791798
115,116,2016-12-01,746.046021,758.275024,746.046021,756.773987,756.773987,80461904.0,742.3323538571434,64.52472559945791,1129238024.0,0.3858966386725583,0.09737998493129689
116,117,2016-12-02,757.544983,781.296021,757.544983,777.94397,777.94397,127605000.0,744.2151358571435,70.60197409557897,1256843024.0,0.4358978836967968,0.08721097579793231
117,118,2016-12-03,778.2479860000002,778.2479860000002,764.856018,771.155029,771.155029,69547296.0,745.6107787857147,66.6582943779082,1187295728.0,0.39901178578427254,0.11144809775762156
118,119,2016-12-04,771.638,773.8720089999998,768.161011,773.8720089999998,773.8720089999998,60557900.0,748.6712079285719,67.44210333708432,1247853628.0,0.46165936897146925,0.1309278790288918
119,120,2016-12-05,773.393982,773.4680179999998,751.7130129999998,758.700012,758.700012,106363000.0,750.0606383571434,59.088626114947594,1141490628.0,0.4403921427163372,0.05211500577001582
120,121,2016-12-06,758.719971,765.6220089999998,758.719971,764.223999,764.223999,116218000.0,750.9804250714292,60.983494870361135,1257708628.0,0.43111611681925893,0.08253939564425497
121,122,2016-12-07,764.210999,771.5430299999998,759.75,768.132019,768.132019,96426096.0,752.6617125714291,62.31337095628054,1354134724.0,0.43066127403342286,0.11552530536023935
122,123,2016-12-08,768.0759889999998,774.6979980000001,765.945984,770.8099980000002,770.8099980000002,80111904.0,754.8417837857148,63.238061233929265,1434246628.0,0.42764169898008414,0.09540924879526051
123,124,2016-12-09,769.94397,774.528015,769.648987,772.794006,772.794006,68705296.0,757.0664280000008,63.94390506340592,1502951924.0,0.4318727753727753,0.1339200737534071
124,125,2016-12-10,773.02301,777.09198,772.909973,774.650024,774.650024,53843100.0,759.8712855000006,64.62811884938483,1556795024.0,0.427773616187094,0.10213808167141135
125,126,2016-12-11,774.7520139999998,774.7979740000002,765.4119870000002,769.731018,769.731018,57313400.0,762.5638601428578,61.30759021587428,1499481624.0,0.523235868556758,0.16856895805630417
126,127,2016-12-12,770.039978,781.9219969999998,770.039978,780.086975,780.086975,76571000.0,765.7262877857149,65.3445533609613,1576052624.0,0.4252006549561707,0.151830808807553
127,128,2016-12-13,780.646973,788.460022,777.961975,780.55603,780.55603,81645600.0,768.9371467857147,65.52002790648106,1657698224.0,0.452328544048698,0.1504163996927906
128,129,2016-12-14,780.005005,782.033997,776.838989,781.481018,781.481018,75979000.0,771.4935781428578,65.88685499458914,1733677224.0,0.4751739923095953,0.06867809919725688
129,130,2016-12-15,780.070007,781.4349980000002,777.8020019999999,778.0880129999998,778.0880129999998,81580096.0,773.0160085714293,63.22951321655139,1652097128.0,0.4209894148642059,0.09903469116011634
130,131,2016-12-16,778.9630129999998,785.0319820000002,778.9630129999998,784.9069820000002,784.9069820000002,83608200.0,773.5133665714293,66.1815466969848,1735705328.0,0.44657338308457706,0.10995424662402274
131,132,2016-12-17,785.166016,792.508972,784.864014,790.828979,790.828979,78989800.0,774.9186487142863,68.54347542432325,1814695128.0,0.4856376398076961,0.16775904184207535
132,133,2016-12-18,791.007996,794.737,788.026001,790.530029,790.530029,60524400.0,776.1085072857151,68.28420774506094,1754170728.0,0.49854997638593285,0.09142328936669131
133,134,2016-12-19,790.692017,793.611023,790.320007,792.713989,792.713989,74886400.0,778.5380770714293,69.20075146292307,1829057128.0,0.470254546610528,0.08607174410310298
134,135,2016-12-20,792.2470089999998,801.336975,791.4970089999998,800.8759769999998,800.8759769999998,99629296.0,781.1560755000007,72.40974796541191,1928686424.0,0.48200250620018537,0.15484636188117012
135,136,2016-12-21,800.643982,834.2810059999998,799.405029,834.2810059999998,834.2810059999998,155576000.0,785.8810031428578,81.09258794057519,2084262424.0,0.4510065803094102,0.1240016151042017
136,137,2016-12-22,834.179993,875.7819820000002,834.148987,864.5399779999998,864.5399779999998,200027008.0,792.5760017142862,85.53369111713356,2284289432.0,0.4469231245401197,0.10012781416722304
137,138,2016-12-23,864.888,925.117004,864.6770019999999,921.984009,921.984009,275564000.0,803.2324305000004,90.2268755732285,2559853432.0,0.47981778330590963,0.11214325601119784
138,139,2016-12-24,922.179993,923.479004,886.3350220000002,898.8220210000002,898.8220210000002,137727008.0,812.1018588571434,79.08586994287981,2422126424.0,0.43748935541027384,0.1367217294787336
139,140,2016-12-25,899.651978,899.651978,862.424011,896.182983,896.182983,143664992.0,821.1341420714291,77.90551888277001,2278461432.0,0.4363019749986666,0.09329813290009725
140,141,2016-12-26,896.9050289999999,913.184021,896.89801,907.609985,907.609985,123771000.0,830.2429285000004,79.34315084393663,2402232432.0,0.4448583176219206,0.11302393207282913
141,142,2016-12-27,908.354004,940.047974,904.255005,933.197998,933.197998,167308000.0,841.1459262142862,82.1448213331081,2569540432.0,0.3423414339343142,0.06267736409820855
142,143,2016-12-28,934.830994,975.921021,934.830994,975.921021,975.921021,236630000.0,855.0344978571433,85.64549283760442,2806170432.0,0.4642437089650239,0.16794784574938473
143,144,2016-12-29,975.125,979.396973,954.502991,973.497009,973.497009,199320000.0,868.9922832857147,84.6316343050015,2606850432.0,0.5040048505391269,0.13902837437102594
144,145,2016-12-30,972.534973,972.534973,934.833008,961.237976,961.237976,187474000.0,881.5873542857147,79.50565332474903,2419376432.0,0.4012010398295121,0.13840175064133398
145,146,2016-12-31,960.627014,963.742981,947.236023,963.742981,963.742981,99135104.0,893.938354428572,79.77521934651084,2518511536.0,0.5036383763232827,0.18904601221016915
146,147,2017-01-01,963.65802,1003.080017,958.698975,998.325012,998.325012,147775008.0,908.780853214286,83.08328223290127,2666286544.0,0.3739644505820976,0.1147009618241236
147,148,2017-01-02,998.617004,1031.390015,996.702026,1021.75,1021.75,222184992.0,925.1405682857147,84.88657557803234,2888471536.0,0.4585041675989692,0.14340830749920083
148,149,2017-01-03,1021.599976,1044.079956,1021.599976,1043.839966,1043.839966,185168000.0,942.4951389285718,86.36287193753219,3073639536.0,0.42154138542971165,0.11654200940190493
149,150,2017-01-04,1044.400024,1159.420044,1044.400024,1154.72998,1154.72998,344945984.0,965.3843513571434,91.07559567902862,3418585520.0,0.43099501787246886,0.08510931443284386
150,151,2017-01-05,1156.72998,1191.099976,910.416992,1013.380005,1013.380005,510199008.0,976.0157818571432,61.7716433199956,2908386512.0,0.4610340119693861,0.16543462442697135
151,152,2017-01-06,1014.23999,1046.810059,883.9439699999998,902.200989,902.200989,351876000.0,974.6027090000006,48.54186874761295,2556510512.0,0.4670456063221891,0.11570723102429675
152,153,2017-01-07,903.487,908.585022,823.55603,908.585022,908.585022,279550016.0,975.3000662142862,49.214473954522894,2836060528.0,0.46358736552127777,0.0969245039466827
153,154,2017-01-08,908.174988,942.723999,887.2490230000002,911.198975,911.198975,158715008.0,976.372637071429,49.50550384265444,2994775536.0,0.4546355217878465,0.1210398287105911
154,155,2017-01-09,913.244019,913.685974,879.807007,902.828003,902.828003,141876992.0,976.0310669285719,48.546071127718925,2852898544.0,0.3873325712286751,0.1151617637413092
155,156,2017-01-10,902.440002,914.872986,901.059998,907.679016,907.679016,115808000.0,974.2082825000006,49.16096416627133,2968706544.0,0.42213403923056375,0.08792437600897819
156,157,2017-01-11,908.11499,919.447998,762.7650150000002,777.757019,777.757019,310928992.0,960.053710928572,36.5596034576924,2657777552.0,0.39911724543556526,0.09524286218365166
157,158,2017-01-12,775.177979,826.2459719999998,755.7559809999998,804.833984,804.833984,222326000.0,948.0063520000006,40.01081809941388,2880103552.0,0.4409223048934992,0.096310799709822
158,159,2017-01-13,803.737,829.0009769999998,780.0029910000002,823.984009,823.984009,168968000.0,938.2024972142864,42.39753651282212,3049071552.0,0.3624238437006734,0.1303146572147473
159,160,2017-01-14,825.142029,835.085022,812.455994,818.4119870000002,818.4119870000002,93063296.0,927.821711928572,41.87548156119732,2956008256.0,0.456621011627559,0.14272180137740836
160,161,2017-01-15,818.142029,823.307007,812.8709719999998,821.7979740000002,821.7979740000002,71013600.0,915.2126377857151,42.34011081174129,3027021856.0,0.4462689038484867,0.022942771673701963
161,162,2017-01-16,821.78302,834.530029,820.270996,831.533997,831.533997,82755200.0,901.6257804285723,43.73289159078789,3109777056.0,0.41990609976447313,0.10514137373218982
162,163,2017-01-17,830.945984,910.560974,830.796021,907.937988,907.937988,155095008.0,891.918496285715,53.2719545258032,3264872064.0,0.4509076415010726,0.07162253045990291
163,164,2017-01-18,909.372986,917.499023,858.304016,886.6179810000001,886.6179810000001,225676992.0,872.7676392142863,50.68954287032718,3039195072.0,0.4377879277474116,0.16191307458714424
164,165,2017-01-19,888.3350220000002,904.614014,884.338013,899.0729980000001,899.0729980000001,105625000.0,864.6028530000007,52.14889624576181,3144820072.0,0.4016372169497169,0.07529646857771859
165,166,2017-01-20,898.171997,899.39801,887.007996,895.026001,895.026001,86728400.0,864.0903538571434,51.614374536610406,3058091672.0,0.44206163121093683,0.11216237092973204
166,167,2017-01-21,895.549011,927.367004,895.534973,921.789001,921.789001,111158000.0,865.0334952142862,54.906107155629975,3169249672.0,0.4312863976136298,0.06658380617398474
167,168,2017-01-22,922.205017,937.525024,897.564026,924.672974,924.672974,116573000.0,865.9959237142864,55.25933239761161,3285822672.0,0.42902307630636244,0.1317792855705842
168,169,2017-01-23,925.499023,928.265991,916.737976,921.012024,921.012024,73588600.0,867.2947823571434,54.67386719587846,3212234072.0,0.4088980329021313,0.1246930128917834
169,170,2017-01-24,910.677002,924.14502,892.2860109999998,892.6870119999999,892.6870119999999,111349000.0,866.2239249285719,50.238842275688235,3100885072.0,0.4640081168172143,0.11260535020991269
170,171,2017-01-25,891.924011,903.252014,891.6870119999999,901.541992,901.541992,120831000.0,875.0657087142862,51.561682777780476,3221716072.0,0.4243667087314628,0.1332077022381838
171,172,2017-01-26,902.39502,919.325989,902.223999,917.585999,917.585999,131958000.0,883.1194240714293,53.9503376214374,3353674072.0,0.4296286858060114,0.07612834463125161
172,173,2017-01-27,918.359009,923.223022,915.846008,919.75,919.75,125594000.0,889.9598520000006,54.27784444059781,3479268072.0,0.45895615817313756,0.1212477099943217
173,174,2017-01-28,919.810974,923.911011,919.810974,921.590027,921.590027,68979600.0,897.3297120000008,54.573681691675205,3548247672.0,0.38773817561087154,0.01981844864045325
174,175,2017-01-29,922.067017,923.41803,919.14801,919.495972,919.495972,60851700.0,904.308140428572,54.144315739495646,3487395972.0,0.3744949494949495,0.06183441558441558
175,176,2017-01-30,920.151001,923.047974,919.473999,920.382019,920.382019,78227296.0,910.6544277142864,54.30812433788174,3565623268.0,0.3951234581302969,0.13536960683693208
176,177,2017-01-31,920.958984,972.018982,920.958984,970.403015,970.403015,164582000.0,915.1162153571436,62.46093298841258,3730205268.0,0.43662141251703906,0.09495631832325382
177,178,2017-02-01,970.940979,989.114014,970.742004,989.02301,989.02301,150110000.0,922.4308602857152,64.96681055961236,3880315268.0,0.46653631414901175,0.13125444057095534
178,179,2017-02-02,990.000977,1013.52002,983.221008,1011.799988,1011.799988,145820992.0,930.482788142858,67.79854843223265,4026136260.0,0.38908441970295427,0.05794322216304975
179,180,2017-02-03,1011.460022,1033.869995,1008.789978,1029.910034,1029.910034,201278000.0,940.1173619285722,69.88300631336122,4227414260.0,0.4140260767105898,0.12808103616936042
180,181,2017-02-04,1031.329956,1045.900024,1015.159973,1042.900024,1042.900024,155064000.0,948.7681492857151,71.3172168576159,4382478260.0,0.45222543193776216,0.1286302515118747
181,182,2017-02-05,1043.52002,1043.630005,1022.369995,1027.339966,1027.339966,114208000.0,956.1015058571436,67.18968014383151,4268270260.0,0.43651983834086466,0.10856452382735238
182,183,2017-02-06,1028.400024,1044.640015,1028.160034,1038.150024,1038.150024,111762000.0,964.4685058571437,68.55143486482629,4380032260.0,0.4315517154654752,0.1119875290209087
183,184,2017-02-07,1040.140015,1061.930054,1040.140015,1061.349976,1061.349976,146007008.0,976.5158604285724,71.30409212895363,4526039268.0,0.39582256991979214,0.08814677060336784
184,185,2017-02-08,1062.319946,1078.969971,1037.48999,1063.069946,1063.069946,201855008.0,988.0535714285722,71.50323526001544,4727894276.0,0.41388947106338403,0.08222639776987603
185,186,2017-02-09,1064.699951,1088.98999,953.343994,994.382996,994.382996,407220000.0,993.5390712142863,55.067802277283,4320674276.0,0.32484261931484154,0.04554644326866549
186,187,2017-02-10,995.632019,998.905029,946.690979,988.674011,988.674011,190452000.0,998.4622148571435,53.957661814589386,4130222276.0,0.43049339853096813,0.15620365938491668
187,188,2017-02-11,988.89801,1009.289978,982.830017,1004.450012,1004.450012,102261000.0,1004.3807852142863,56.56355815858129,4232483276.0,0.44224272997305075,0.11170527000910208
188,189,2017-02-12,1003.52002,1004.76001,996.921021,999.18103,999.18103,67530000.0,1010.0725750714292,55.435065331442736,4164953276.0,0.3833478206097254,0.08493795666414715
189,190,2017-02-13,998.88501,1002.099976,976.002014,990.642029,990.642029,100607000.0,1015.0911472142864,53.56977293364769,4064346276.0,0.42272012536989717,0.0763016074611663
190,191,2017-02-14,991.734985,1011.51001,986.471008,1004.549988,1004.549988,137946000.0,1017.5302167142863,56.157388709813496,4202292276.0,0.41722842267213334,0.0657599870371883
191,192,2017-02-15,1006.210022,1008.840027,1001.580017,1007.47998,1007.47998,89759400.0,1018.8485717142863,56.70481580663356,4292051676.0,0.504735821748054,0.13248688198397637
192,193,2017-02-16,1007.650024,1033.369995,1007.650024,1027.439941,1027.439941,122277000.0,1019.9657112142862,60.33796174902028,4414328676.0,0.4278662847137314,0.12132122404668244
193,194,2017-02-17,1026.119995,1053.170044,1025.640015,1046.209961,1046.209961,136474000.0,1021.1299917142862,63.44455937164036,4550802676.0,0.4805671403240421,0.18683841674704388
194,195,2017-02-18,1049.209961,1061.099976,1046.959961,1054.420044,1054.420044,99073504.0,1021.9528502857147,64.74531094745916,4649876180.0,0.4365021057107053,0.1266701878478664
195,196,2017-02-19,1054.76001,1056.810059,1043.459961,1047.869995,1047.869995,77423296.0,1023.4192809285719,62.8246354354273,4572452884.0,0.3969673818245246,0.0782657448371734
196,197,2017-02-20,1048.689941,1080.48999,1041.689941,1079.97998,1079.97998,109478000.0,1026.4071349285718,67.85840509409289,4681930884.0,0.3800926365169724,0.06270544373663443
197,198,2017-02-21,1079.280029,1117.25,1076.930054,1115.300049,1115.300049,186868992.0,1030.2607115714293,72.30127860073695,4868799876.0,0.46877913846059655,0.15753405103146645
198,199,2017-02-22,1114.800049,1125.390015,1100.550049,1117.439941,1117.439941,136100000.0,1034.144282642858,72.54885654918947,5004899876.0,0.4358772625777262,0.042704572278232086
199,200,2017-02-23,1117.27002,1176.619995,1116.959961,1166.719971,1166.719971,189454000.0,1046.4540665714294,77.52990661450724,5194353876.0,0.42256315184768967,0.1282613155031202
200,201,2017-02-24,1172.709961,1200.390015,1131.959961,1173.680054,1173.680054,330759008.0,1059.6687839285719,78.13339641957701,5525112884.0,0.4529151718204492,0.08705265098640348
201,202,2017-02-25,1170.410034,1174.849976,1124.589966,1143.839966,1143.839966,139960992.0,1069.6252092142863,69.51345526558833,5385151892.0,0.38916743702874995,0.1093780856605195
202,203,2017-02-26,1144.27002,1167.469971,1130.199951,1165.199951,1165.199951,116486000.0,1081.4837035714295,71.90298940739447,5501637892.0,0.4470824015089907,0.13933525157374776
203,204,2017-02-27,1163.780029,1181.97998,1163.380005,1179.969971,1179.969971,131570000.0,1095.0071280000009,73.45249642045442,5633207892.0,0.4951905258499291,0.1452187816658111
204,205,2017-02-28,1180.719971,1193.25,1171.819946,1179.969971,1179.969971,184956000.0,1107.537126785715,73.45249642045442,5633207892.0,0.3748410285836245,0.0545934415898121
205,206,2017-03-01,1180.040039,1222.5,1179.689941,1222.5,1222.5,229056992.0,1122.8956996428576,77.58132887033969,5862264884.0,0.45133733631540646,0.14595985439187195
206,207,2017-03-02,1224.680054,1262.130005,1215.619995,1251.01001,1251.01001,368275008.0,1138.8649902857146,79.84434130883217,6230539892.0,0.41663850529939767,0.07884789092618728
207,208,2017-03-03,1250.709961,1280.310059,1250.709961,1274.98999,1274.98999,315739008.0,1155.206420928572,81.53288484441771,6546278900.0,0.4244225211584528,0.14800705420957708
208,209,2017-03-04,1277.430054,1279.400024,1230.51001,1255.150024,1255.150024,183270000.0,1169.5442766428575,75.86970379743556,6363008900.0,0.38854652849851173,0.0875872541545942
209,210,2017-03-05,1254.290039,1267.290039,1238.060059,1267.119995,1267.119995,134127000.0,1185.2049909285718,76.91167776760621,6497135900.0,0.42912399204250246,0.042451825896176694
210,211,2017-03-06,1267.469971,1276.0,1264.599976,1272.829956,1272.829956,153656992.0,1198.979989214286,77.41272964543674,6650792892.0,0.4343119650006468,0.11661653897670182
211,212,2017-03-07,1273.209961,1275.550049,1204.800049,1223.540039,1223.540039,291256000.0,1206.7114170714287,64.41700561413089,6359536892.0,0.4723576058201058,0.09845318813131314
212,213,2017-03-08,1223.22998,1232.160034,1148.079956,1150.0,1150.0,332603008.0,1209.0371355714287,50.732606625039466,6026933884.0,0.469741858430761,0.13026088651577342
213,214,2017-03-09,1150.349976,1197.459961,1141.22998,1188.48999,1188.48999,212283008.0,1210.5921369285716,56.0009830132391,6239216892.0,0.4618829221755673,0.0456562508491456
214,215,2017-03-10,1189.359985,1270.469971,1077.25,1116.719971,1116.719971,563795968.0,1206.5235595714287,46.10150568432686,5675420924.0,0.46597833082989887,0.08904923310279375
215,216,2017-03-11,1116.319946,1193.829956,1116.319946,1175.829956,1175.829956,283320000.0,1208.808558857143,53.4068568180517,5958740924.0,0.411747224867673,0.07786728047862501
216,217,2017-03-12,1176.619995,1226.97998,1175.359985,1221.380005,1221.380005,227176000.0,1212.821419857143,58.117787957366936,6185916924.0,0.39267865410052916,0.11192354347041845
217,218,2017-03-13,1221.780029,1237.369995,1217.030029,1231.920044,1231.920044,380276992.0,1216.532139357143,59.147096848638064,6566193916.0,0.397282116631582,0.06688048419399323
218,219,2017-03-14,1232.160034,1244.810059,1220.719971,1240.0,1240.0,245306000.0,1220.8199985714286,59.95949168913166,6811499916.0,0.46680621998103883,0.1509447999665391
219,220,2017-03-15,1240.160034,1251.609985,1239.75,1249.609985,1249.609985,297804992.0,1222.7564260714287,60.95402403389142,7109304908.0,0.44698003570929834,0.10916943629846854
220,221,2017-03-16,1251.329956,1257.97998,1152.439941,1187.810059,1187.810059,638568000.0,1218.2421438571432,52.007835648434344,6470736908.0,0.43605587460248485,0.09499290371430202
221,222,2017-03-17,1180.160034,1180.160034,1099.569946,1100.22998,1100.22998,706598976.0,1205.7592860000004,42.490246226429726,5764137932.0,0.41383386066110145,0.08098764664251494
222,223,2017-03-18,1099.689941,1114.069946,957.655029,973.817993,973.817993,621302016.0,1185.664140928572,33.08016350270192,5142835916.0,0.3954478055775065,0.05621255544152879
223,224,2017-03-19,976.72998,1069.910034,976.72998,1036.73999,1036.73999,406648000.0,1169.208426285715,40.18147870530389,5549483916.0,0.5413899911816579,0.14267361111111113
224,225,2017-03-20,1037.23999,1063.030029,1036.680054,1054.22998,1054.22998,286529984.0,1153.594142285715,42.02314244621867,5836013900.0,0.44517611539985485,0.08176832416013088
225,226,2017-03-21,1055.359985,1122.430054,1055.359985,1120.540039,1120.540039,337391008.0,1146.2369994285725,48.49724615942007,6173404908.0,0.3455710989822286,0.06262857274692823
226,227,2017-03-22,1120.650024,1120.650024,1014.210022,1049.140015,1049.140015,380840992.0,1139.0327147857151,42.937382146734905,5792563916.0,0.4464310745816531,0.12273957576874277
227,228,2017-03-23,1050.050049,1058.01001,1028.930054,1038.589966,1038.589966,248540000.0,1128.3255702142865,42.168123879616864,5544023916.0,0.39565198477859886,0.15779972169947065
228,229,2017-03-24,1038.449951,1040.469971,934.357971,937.52002,937.52002,491038016.0,1115.5255737142863,35.58981092078268,5052985900.0,0.39989589912003703,0.08129515599343187
229,230,2017-03-25,936.539978,975.760986,903.713013,972.778992,972.778992,435803008.0,1101.0219334285723,39.155813371664266,5488788908.0,0.42788400030483303,0.08328240288734412
230,231,2017-03-26,974.015015,1007.960022,954.185974,966.724976,966.724976,303668000.0,1082.8322885000011,38.75902538658271,5185120908.0,0.4262662337662337,0.08639610389610393
231,232,2017-03-27,972.054993,1046.400024,971.984009,1045.77002,1045.77002,372535008.0,1069.5358582142862,46.396829342815295,5557655916.0,0.4185850135850136,0.10212870012870014
232,233,2017-03-28,1044.579956,1064.650024,1027.72998,1047.150024,1047.150024,326332000.0,1055.7608599285722,46.52222719794798,5883987916.0,0.4075960085709165,0.046353572662763694
233,234,2017-03-29,1046.079956,1055.130005,1015.880005,1039.969971,1039.969971,298457984.0,1040.7865732142866,45.920310442921725,5585529932.0,0.39676750347698453,0.06200710747585747
234,235,2017-03-30,1042.209961,1049.290039,1020.039978,1026.430054,1026.430054,352968992.0,1029.2594300000007,44.744628424139634,5232560940.0,0.4151366674167044,0.09636003385823745
235,236,2017-03-31,1026.640015,1074.920044,1026.640015,1071.790039,1071.790039,447287008.0,1027.228005642858,49.416939469254295,5679847948.0,0.4635879387367483,0.029575316658649986
236,237,2017-04-01,1071.709961,1091.719971,1061.089966,1080.5,1080.5,289633984.0,1034.8481490000008,50.286224067976455,5969481932.0,0.4250139107897638,0.06897015726045193
237,239,2017-04-03,1102.949951,1151.73999,1102.949951,1143.810059,1143.810059,580444032.0,1045.9203013571434,56.44222248356731,7064112972.0,0.42595399245103865,0.14441114280903486
238,240,2017-04-04,1145.52002,1156.439941,1120.52002,1133.25,1133.25,436310016.0,1046.8281557142866,55.183983672712614,6627802956.0,0.4315331514550265,0.1254050925925926
239,241,2017-04-05,1134.140015,1135.089966,1113.630005,1124.780029,1124.780029,414784000.0,1052.2310138571436,54.1414522976189,6213018956.0,0.47171626891497337,0.11846558623449381
240,242,2017-04-06,1125.810059,1188.369995,1125.810059,1182.680054,1182.680054,511222016.0,1062.523163000001,59.74063362438958,6724240972.0,0.4412196537436922,0.1610307400932401
241,243,2017-04-07,1178.939941,1186.579956,1163.390015,1176.900024,1176.900024,317022016.0,1079.6217347142867,58.96662371342529,6407218956.0,0.4443952403934933,0.06731225856536426
242,244,2017-04-08,1172.650024,1184.97998,1162.579956,1175.949951,1175.949951,209312000.0,1094.1339460714296,58.83169647364565,6197906956.0,0.434500954232442,0.08181086427310562
243,245,2017-04-09,1176.569946,1197.209961,1171.859985,1187.869995,1187.869995,242343008.0,1109.930018857144,60.06633027214668,6440249964.0,0.4207147820414644,0.08622192206245213
244,246,2017-04-10,1187.300049,1190.339966,1179.040039,1187.130005,1187.130005,215883008.0,1120.0271606428582,59.94614006305989,6224366956.0,0.39024531890920133,0.06565857941981215
245,247,2017-04-11,1187.459961,1208.069946,1187.459961,1205.01001,1205.01001,216182000.0,1131.3028739285726,61.928421625811396,6440548956.0,0.42365998162085355,0.06613708143513816
246,248,2017-04-12,1204.810059,1207.140015,1196.76001,1200.369995,1200.369995,288702016.0,1142.7600185000008,61.083567379146366,6151846940.0,0.3856051766556424,0.1139769046946842
247,249,2017-04-13,1201.02002,1205.890015,1156.439941,1169.280029,1169.280029,351968992.0,1152.963588142858,55.609314360372665,5799877948.0,0.4481359390253621,0.1131739868037945
248,250,2017-04-14,1170.329956,1190.800049,1159.790039,1167.540039,1167.540039,254827008.0,1159.8028738571436,55.310556260435455,5545050940.0,0.46226310163883355,0.08624792409956705
249,251,2017-04-15,1167.300049,1188.0,1164.959961,1172.52002,1172.52002,203559008.0,1166.3757324285725,56.038520532107576,5748609948.0,0.44738636363636364,0.024897186147186154
250,252,2017-04-16,1172.609985,1187.219971,1172.609985,1182.939941,1182.939941,183231008.0,1172.1450107857152,57.59500072992309,5931840956.0,0.37204070783018145,0.07022293422951317
251,253,2017-04-17,1183.25,1194.900024,1172.650024,1193.910034,1193.910034,253206000.0,1175.7235804285726,59.231539065844714,6185046956.0,0.33226686507936504,0.07037450396825397
252,254,2017-04-18,1193.77002,1217.569946,1193.77002,1211.670044,1211.670044,270524000.0,1181.325012142858,61.8017577795259,6455570956.0,0.4297523232428547,0.05758887166063575
253,255,2017-04-19,1212.130005,1215.51001,1205.079956,1210.290039,1210.290039,288060992.0,1187.4328700000008,61.47743040310009,6167509964.0,0.31290229885057474,-0.01050148312940304
254,256,2017-04-20,1211.079956,1240.790039,1208.410034,1229.079956,1229.079956,315108000.0,1190.7471487142866,64.22995467325188,6482617964.0,0.43091672723668567,0.08291243010253185
255,257,2017-04-21,1229.420044,1235.939941,1215.560059,1222.050049,1222.050049,272167008.0,1193.9721505000011,62.432588148230025,6210450956.0,0.39425293699964753,0.1009155275767118
256,258,2017-04-22,1222.709961,1235.560059,1208.469971,1231.709961,1231.709961,249320000.0,1197.9550083571444,63.92640294521953,6459770956.0,0.3740505722491016,0.059891173641173634
257,259,2017-04-23,1231.920044,1232.199951,1203.939941,1207.209961,1207.209961,258951008.0,1199.3364345000011,57.6636509405868,6200819948.0,0.46784208727096654,0.055817909341616234
258,260,2017-04-24,1209.630005,1250.939941,1209.630005,1250.150024,1250.150024,235806000.0,1203.8378644285726,64.27048429445166,6436625948.0,0.4619507672112204,0.11049464209655242
259,261,2017-04-25,1250.449951,1267.579956,1249.969971,1265.48999,1265.48999,242556000.0,1208.1578630000015,66.29411863360161,6679181948.0,0.40039617157629576,0.1196572259693378
260,262,2017-04-26,1265.98999,1294.829956,1265.930054,1281.079956,1281.079956,329631008.0,1213.9228602142869,68.26153501699778,7008812956.0,0.4571032813295428,0.198988766380519
261,263,2017-04-27,1281.880005,1319.699951,1281.300049,1317.72998,1317.72998,449196992.0,1224.5264281428583,72.34786179180145,7458009948.0,0.47387554537857346,0.024017476876395726
262,264,2017-04-28,1317.73999,1331.280029,1292.369995,1316.47998,1316.47998,527488992.0,1235.1649953571446,72.007340416759,6930520956.0,0.4368753329259582,0.08319006272773397
263,265,2017-04-29,1317.839966,1327.199951,1315.209961,1321.790039,1321.790039,422705984.0,1245.8271395714298,72.59738483548874,7353226940.0,0.43269087745989915,0.017420523819980344
264,266,2017-04-30,1321.869995,1347.910034,1314.920044,1347.890015,1347.890015,413115008.0,1257.6092877142873,75.34793342116564,7766341948.0,0.5346067878076691,0.14075140343162953
265,267,2017-05-01,1348.300049,1434.319946,1348.300049,1421.599976,1421.599976,713624000.0,1273.8728550000014,81.1135768642307,8479965948.0,0.39166962653037085,0.09174944885749206
266,268,2017-05-02,1421.030029,1473.900024,1415.689941,1452.819946,1452.819946,477337984.0,1291.0978480000015,82.93416979899409,8957303932.0,0.3710824876747496,0.061028343394414826
267,269,2017-05-03,1453.780029,1492.77002,1447.48999,1490.089966,1490.089966,583795968.0,1311.08355707143,84.81592569576205,9541099900.0,0.4215093211908386,0.16347432623404856
268,270,2017-05-04,1490.719971,1608.910034,1490.719971,1537.670044,1537.670044,933548992.0,1333.125706214287,86.81474927979919,10474648892.0,0.42158469047294694,0.12478578814034337
269,271,2017-05-05,1540.869995,1618.030029,1530.310059,1555.449951,1555.449951,946035968.0,1356.9399849285726,87.47810317619533,11420684860.0,0.3880042367824323,0.0727503903608227
270,272,2017-05-06,1556.810059,1578.800049,1542.5,1578.800049,1578.800049,582529984.0,1381.7321340714298,88.30990315873818,12003214844.0,0.4009716026839413,0.08269738893340042
271,273,2017-05-07,1579.469971,1596.719971,1559.76001,1596.709961,1596.709961,1080029952.0,1409.5535626428587,88.91797824749632,13083244796.0,0.3728875117203157,0.09516263610524045
272,274,2017-05-08,1596.920044,1723.3499760000002,1596.920044,1723.3499760000002,1723.3499760000002,1340320000.0,1443.353559214287,92.06213918224265,14423564796.0,0.3874601582008835,0.09246532780550157
273,275,2017-05-09,1723.890015,1833.48999,1716.300049,1755.359985,1755.359985,1167920000.0,1478.3442731428586,92.63122844088986,15591484796.0,0.39611620798791847,0.09622423346025319
274,276,2017-05-10,1756.52002,1788.439941,1719.0999760000002,1787.130005,1787.130005,915723008.0,1514.4907052142871,93.15570042523173,16507207804.0,0.3676124132072913,0.0910281926826446
275,277,2017-05-11,1780.369995,1873.930054,1755.3499760000002,1848.569946,1848.569946,799489984.0,1552.4078456428585,94.03927688196528,17306697788.0,0.3840501781879861,0.13359570476731805
276,278,2017-05-12,1845.76001,1856.150024,1694.0100100000002,1724.2399899999998,1724.2399899999998,740984000.0,1581.5335606428582,73.39160152358119,16565713788.0,0.37601829566177786,0.07231343054541407
277,279,2017-05-13,1723.119995,1812.98999,1651.079956,1804.910034,1804.910034,579635008.0,1616.0421317142868,76.93087556740383,17145348796.0,0.4173165743255029,0.07285710970978827
278,280,2017-05-14,1800.859985,1831.420044,1776.619995,1808.910034,1808.910034,437196000.0,1648.9721330714294,77.09357466971895,17582544796.0,0.4888898198575618,0.1651857864357864
279,281,2017-05-15,1808.439941,1812.800049,1708.540039,1738.430054,1738.430054,731529024.0,1671.6028529285725,67.994110743477,16851015772.0,0.43072358458875887,0.09153089619400567
280,282,2017-05-16,1741.699951,1785.939941,1686.540039,1734.449951,1734.449951,959044992.0,1691.7192818571439,67.50951916624751,15891970780.0,0.4372911313819225,0.07987501927597442
281,283,2017-05-17,1726.72998,1864.050049,1661.910034,1839.089966,1839.089966,1064729984.0,1716.6478532857154,72.96485437799322,16956700764.0,0.41667050810166756,0.08114413881494627
282,284,2017-05-18,1818.699951,1904.47998,1807.119995,1888.650024,1888.650024,894321024.0,1741.7178518571438,75.09753732789483,17851021788.0,0.4450540717687326,0.11547292695397635
283,285,2017-05-19,1897.369995,2004.52002,1890.25,1987.709961,1987.709961,1157289984.0,1772.593566857144,78.71228193420987,19008311772.0,0.4022090827741512,0.12142023374900089
284,286,2017-05-20,1984.23999,2084.72998,1974.920044,2084.72998,2084.72998,961336000.0,1808.7314190714294,81.53875187559456,19969647772.0,0.4132683240704631,0.09910500892452763
285,287,2017-05-21,2067.030029,2119.080078,2037.5,2041.199951,2041.199951,1147859968.0,1840.480704071429,76.62303463071287,18821787804.0,0.3871345575267144,0.1451308604249781
286,288,2017-05-22,2043.189941,2303.899902,2017.869995,2173.399902,2173.399902,1942220032.0,1872.6271273571438,80.47321148144881,20764007836.0,0.37566728130740223,0.10757093544895964
287,289,2017-05-23,2191.560059,2320.820068,2178.5,2320.419922,2320.419922,1378749952.0,1912.9885514285725,83.690333248139,22142757788.0,0.3928105959526249,0.11038899982771619
288,290,2017-05-24,2321.3701170000004,2523.719971,2321.3701170000004,2443.639893,2443.639893,1725379968.0,1959.882114857144,85.80169430503551,23868137756.0,0.42384113241256105,0.10820417182024324
289,291,2017-05-25,2446.23999,2763.709961,2285.300049,2304.97998,2304.97998,2406700032.0,1992.4828315714294,74.16635946740111,21461437724.0,0.4440320692039443,0.13680482653920154
290,292,2017-05-26,2320.889893,2573.790039,2071.98999,2202.419922,2202.419922,1763480064.0,2026.6385410000012,66.93607653482067,19697957660.0,0.40005190792872725,0.08176948665918779
291,293,2017-05-27,2196.27002,2260.199951,1855.829956,2038.869995,2038.869995,1700480000.0,2043.3499667857159,57.33679888601776,17997477660.0,0.42331515681555015,0.10157856356273816
292,294,2017-05-28,2054.080078,2267.340088,2054.080078,2155.800049,2155.800049,1147139968.0,2068.1278250000014,61.5791424248247,19144617628.0,0.40517257290513103,0.08559917234947835
293,295,2017-05-29,2159.429932,2307.050049,2107.169922,2255.610107,2255.610107,994625024.0,2105.0692573571437,64.79698706368487,20139242652.0,0.3792550694875678,0.06154412605811028
294,296,2017-05-30,2255.360107,2301.959961,2124.570068,2175.469971,2175.469971,1443970048.0,2136.5706873571444,60.42127859429754,18695272604.0,0.3895781561947397,0.05943590604866036
295,297,2017-05-31,2187.189941,2311.080078,2145.570068,2286.409912,2286.409912,1544829952.0,2168.52211207143,64.0413677773621,20240102556.0,0.385316253774237,0.0502324543453745
296,298,2017-06-01,2288.330078,2448.389893,2288.330078,2407.879883,2407.879883,1653180032.0,2205.6099591428588,67.54198879561723,21893282588.0,0.4286704295641953,0.12270900446630591
297,299,2017-06-02,2404.030029,2488.550049,2373.320068,2488.550049,2488.550049,1317030016.0,2241.384251142859,69.6547997781599,23210312604.0,0.36135297147705236,0.057563574599420186
298,300,2017-06-03,2493.719971,2581.909912,2423.570068,2515.350098,2515.350098,1514950016.0,2272.142831000002,70.34541774281222,24725262620.0,0.3741950844854071,-0.011359447004608302
299,301,2017-06-04,2547.790039,2585.889893,2452.540039,2511.810059,2511.810059,1355120000.0,2305.757838714288,70.11841187835468,23370142620.0,0.48006281423013925,0.0713700596320186
300,302,2017-06-05,2512.399902,2686.810059,2510.219971,2686.810059,2686.810059,1369309952.0,2342.4299927857164,74.49935069569784,24739452572.0,0.4326545962661159,0.1266711412499836
301,303,2017-06-06,2690.840088,2999.909912,2690.840088,2863.199951,2863.199951,2089609984.0,2381.199994857145,78.00040277752771,26829062556.0,0.42260413005138275,0.10372207009407512
302,304,2017-06-07,2869.379883,2869.379883,2700.560059,2732.159912,2732.159912,1517709952.0,2401.8085676428595,70.28073468536749,25311352604.0,0.37123391681287476,0.0967336288182561
303,305,2017-06-08,2720.48999,2815.300049,2670.949951,2805.6201170000004,2805.6201170000004,1281170048.0,2437.568577428574,71.95633108943994,26592522652.0,0.4637251908573748,0.09710132457751507
304,306,2017-06-09,2807.439941,2901.709961,2795.6201170000004,2823.810059,2823.810059,1348950016.0,2481.9535872142887,72.37171449963517,27941472668.0,0.42471674974851625,0.11886406774712457
305,307,2017-06-10,2828.139893,2950.98999,2746.550049,2947.709961,2947.709961,2018889984.0,2546.87072764286,75.07939394547412,29960362652.0,0.42906544291150545,0.16349867874061424
306,308,2017-06-11,2942.409912,2996.600098,2840.530029,2958.110107,2958.110107,1752400000.0,2604.1785889285743,75.29823283054883,31712762652.0,0.4413051680454673,0.12517798648116552
307,309,2017-06-12,2953.219971,2997.26001,2518.560059,2659.629883,2659.629883,2569530112.0,2633.0371443571453,59.22416929362031,29143232540.0,0.39608677191766156,0.1178690269510582
308,310,2017-06-13,2680.909912,2789.040039,2650.379883,2717.02002,2717.02002,1781200000.0,2671.719290714289,60.95026689706882,30924432540.0,0.4807493222263945,0.11052932913994944
309,311,2017-06-14,2716.879883,2786.830078,2412.939941,2506.3701170000004,2506.3701170000004,1696560000.0,2687.4307339285738,52.21344356197471,29227872540.0,0.491785845051499,0.13551992509054198
310,312,2017-06-15,2499.580078,2534.709961,2212.959961,2464.580078,2464.580078,2026259968.0,2691.480747857145,50.66192898425792,27201612572.0,0.3884714488814343,0.0866260421092712
311,313,2017-06-16,2469.570068,2539.919922,2385.149902,2518.560059,2518.560059,1195190016.0,2693.624320000003,52.62036708578928,28396802588.0,0.4399382993117953,0.08446275768252992
312,314,2017-06-17,2514.01001,2685.189941,2484.959961,2655.879883,2655.879883,1534509952.0,2703.6621617857168,57.26736571346907,29931312540.0,0.4507698582436836,0.1307663477337454
313,315,2017-06-18,2655.350098,2662.100098,2516.330078,2548.290039,2548.290039,1178659968.0,2706.26787464286,52.89033221293309,28752652572.0,0.3766141848612064,0.10067211918755255
314,316,2017-06-19,2549.030029,2662.850098,2549.030029,2589.600098,2589.600098,1446840064.0,2699.324306000003,54.333573401372654,30199492636.0,0.44444019590923695,0.11755617459732401
315,317,2017-06-20,2591.26001,2763.449951,2589.820068,2721.790039,2721.790039,1854189952.0,2689.223598000003,58.69436609524244,32053682588.0,0.4381663145982886,0.050282173231379394
316,318,2017-06-21,2709.429932,2772.01001,2660.399902,2689.100098,2689.100098,1626579968.0,2686.1478970000026,57.23871040008866,30427102620.0,0.4096770216064312,0.10564436253652401
317,319,2017-06-22,2691.030029,2723.73999,2642.360107,2705.409912,2705.409912,1097939968.0,2678.990025214289,57.80103055157043,31525042588.0,0.4321246515329902,0.09309465528373079
318,320,2017-06-23,2707.340088,2765.169922,2706.3701170000004,2744.909912,2744.909912,961318976.0,2673.3543004285743,59.20036617132814,32486361564.0,0.40632488796086164,0.08687986007397136
319,321,2017-06-24,2738.52002,2757.939941,2583.189941,2608.719971,2608.719971,982750016.0,2649.140729714288,52.710312949746466,31503611548.0,0.43730170374952637,0.11992446948594371
320,322,2017-06-25,2607.25,2682.26001,2552.1201170000004,2589.409912,2589.409912,1161100032.0,2622.805001500003,51.84248638523086,30342511516.0,0.35745195491572307,0.03216120969744157
321,323,2017-06-26,2590.570068,2615.25,2376.290039,2478.449951,2478.449951,1663280000.0,2609.8635777857166,47.048963716113356,28679231516.0,0.4128974837798367,0.08848375072639779
322,324,2017-06-27,2478.449951,2552.449951,2332.98999,2552.449951,2552.449951,1489789952.0,2598.108572857145,50.34635300809744,30169021468.0,0.3975891773874335,0.07552246268169203
323,325,2017-06-28,2553.030029,2603.97998,2484.419922,2574.790039,2574.790039,1183869952.0,2602.99571014286,51.331679060379095,31352891420.0,0.44146895717330015,0.07012402001490238
324,326,2017-06-29,2567.560059,2588.830078,2510.47998,2539.320068,2539.320068,949979008.0,2608.334280857146,49.64713024456145,30402912412.0,0.44882349522017295,0.10006134456167678
325,327,2017-06-30,2539.23999,2559.25,2478.429932,2480.840088,2480.840088,860273024.0,2605.6399972142885,46.913575774941165,29542639388.0,0.41125166344646286,0.10684170114511395
326,328,2017-07-01,2492.600098,2515.27002,2419.22998,2434.550049,2434.550049,779913984.0,2589.830723357145,44.810391457862075,28762725404.0,0.4328344064493133,0.16281317836752618
327,329,2017-07-02,2436.399902,2514.280029,2394.840088,2506.469971,2506.469971,803747008.0,2586.8435756428594,48.66135613542843,29566472412.0,0.4872190308123574,0.1671369661842223
328,330,2017-07-03,2498.560059,2595.0,2480.469971,2564.060059,2564.060059,964112000.0,2585.0192871428594,51.575181002897786,30530584412.0,0.3818147925236836,0.10756098810868742
329,331,2017-07-04,2561.0,2631.590088,2559.350098,2601.639893,2601.639893,985516032.0,2576.437133857145,53.432529915365585,31516100444.0,0.44245968251969914,0.0892684528409347
330,332,2017-07-05,2602.8701170000004,2622.649902,2538.550049,2601.98999,2601.98999,941566016.0,2570.2149832857167,53.45044254150085,32457666460.0,0.4233459358810351,0.06031154067380763
331,333,2017-07-06,2608.100098,2616.719971,2581.689941,2608.560059,2608.560059,761956992.0,2563.29713664286,53.809525886417475,33219623452.0,0.42399022588311497,0.07637972868343115
332,334,2017-07-07,2608.590088,2916.139893,2498.8701170000004,2518.659912,2518.659912,917411968.0,2547.136422357145,48.317196357047976,32302211484.0,0.3942801457447503,0.09366071736511787
333,335,2017-07-08,2520.27002,2571.340088,2492.310059,2571.340088,2571.340088,733329984.0,2544.466430714288,51.44475234520802,33035541468.0,0.4676695223867843,0.12103358557227603
334,336,2017-07-09,2572.610107,2635.48999,2517.590088,2518.439941,2518.439941,527856000.0,2539.3971470714305,48.28491420259079,32507685468.0,0.4087007388419477,0.11887674248828095
335,337,2017-07-10,2525.25,2537.159912,2321.129883,2372.560059,2372.560059,1111200000.0,2531.833583357145,40.83604080081489,31396485468.0,0.4077227218571045,0.10095639537336225
336,338,2017-07-11,2385.889893,2413.469971,2296.810059,2337.790039,2337.790039,1329760000.0,2516.500732500001,39.28060697346505,30066725468.0,0.4521806344352765,0.06918129628983125
337,339,2017-07-12,2332.77002,2423.709961,2275.139893,2398.840088,2398.840088,1117410048.0,2503.9328788571443,43.36001196802405,31184135516.0,0.4083046836866704,0.09102554728759855
338,340,2017-07-13,2402.699951,2425.219971,2340.830078,2357.899902,2357.899902,835769984.0,2490.9742955714296,41.353551123513434,30348365532.0,0.37172145954404023,0.09862154476348026
339,341,2017-07-14,2360.590088,2363.25,2183.219971,2233.340088,2233.340088,882502976.0,2473.2957241428585,35.9090506253317,29465862556.0,0.3990641423705244,0.08187775658897635
340,342,2017-07-15,2230.1201170000004,2231.139893,1990.410034,1998.859985,1998.859985,993608000.0,2442.175005285716,28.34390015498178,28472254556.0,0.4051294032275942,0.08339725369854428
341,343,2017-07-16,1991.97998,2058.77002,1843.030029,1929.819946,1929.819946,1182870016.0,2400.985717785716,26.569020518581127,27289384540.0,0.4298995888846656,0.08791245442795718
342,344,2017-07-17,1932.619995,2230.48999,1932.619995,2228.409912,2228.409912,1201760000.0,2377.0107072857168,43.14965857736167,28491144540.0,0.4266673989590657,0.10167611192469148
343,345,2017-07-18,2233.52002,2387.610107,2164.77002,2318.879883,2318.879883,1512450048.0,2356.813563714288,47.050829712167406,30003594588.0,0.3828208056024975,0.06897105866217428
344,346,2017-07-19,2323.080078,2397.169922,2260.22998,2273.429932,2273.429932,1245100032.0,2333.3449881428587,45.36656079653226,28758494556.0,0.525614642420198,0.12821455383955382
345,347,2017-07-20,2269.889893,2900.699951,2269.889893,2817.600098,2817.600098,2249260032.0,2348.2764195000022,62.61983034462803,31007754588.0,0.3867114228754875,0.06567380201906843
346,348,2017-07-21,2838.409912,2838.409912,2621.850098,2667.76001,2667.76001,1489449984.0,2358.926426500001,57.257842543105625,29518304604.0,0.4267836251451121,0.11470239237332427
347,349,2017-07-22,2668.629883,2862.419922,2657.709961,2810.1201170000004,2810.1201170000004,1177129984.0,2375.9821428571445,60.70087987502446,30695434588.0,0.4306500760211719,0.07468213020042289
348,350,2017-07-23,2808.100098,2832.179932,2653.939941,2730.399902,2730.399902,1072840000.0,2391.1221400714303,57.88869486501075,29622594588.0,0.4425619152290604,0.05361632717159789
349,351,2017-07-24,2732.699951,2777.26001,2699.189941,2754.860107,2754.860107,866473984.0,2418.429286357144,58.5236251002611,30489068572.0,0.37556604095492985,0.06705827197493863
350,352,2017-07-25,2757.5,2768.080078,2480.959961,2576.47998,2576.47998,1460089984.0,2435.478567857145,52.32739570803878,29028978588.0,0.4662454367400288,0.13390776458376588
351,353,2017-07-26,2577.77002,2610.76001,2450.800049,2529.449951,2529.449951,937404032.0,2444.807843785716,50.800266718200405,28091574556.0,0.35649775683239415,0.07551283879420592
352,354,2017-07-27,2538.709961,2693.320068,2529.340088,2671.780029,2671.780029,789104000.0,2467.227852857145,55.073488399759846,28880678556.0,0.4089135261310717,0.04595104969003274
353,355,2017-07-28,2679.72998,2897.449951,2679.72998,2809.01001,2809.01001,1380099968.0,2508.3471330000025,58.789974849043595,30260778524.0,0.4129663132191212,0.09431406678101525
354,356,2017-07-29,2807.02002,2808.76001,2692.800049,2726.449951,2726.449951,803745984.0,2560.3178448571452,55.799332140539505,29457032540.0,0.40197897369772373,0.04147365912990913
355,357,2017-07-30,2724.389893,2758.530029,2644.850098,2757.179932,2757.179932,705942976.0,2619.414986714288,56.682616326268786,30162975516.0,0.4834574778396206,0.06695309214594929
356,358,2017-07-31,2763.23999,2889.6201170000004,2720.610107,2875.340088,2875.340088,860574976.0,2665.6242850000017,59.993159989452494,31023550492.0,0.41071124148201077,0.1168374755279117
357,359,2017-08-01,2871.300049,2921.350098,2685.610107,2718.26001,2718.26001,1324669952.0,2694.151436928573,54.07645332634414,29698880540.0,0.4323817413699196,0.0766538568546503
358,360,2017-08-02,2727.129883,2762.530029,2668.590088,2710.669922,2710.669922,1094950016.0,2725.382864785716,53.80034864072909,28603930524.0,0.40741692691799003,0.06525971038717848
359,361,2017-08-03,2709.560059,2813.310059,2685.139893,2804.72998,2804.72998,804796992.0,2724.4635706428585,56.74761096096811,29408727516.0,0.43675612303513317,0.09662491982214318
360,362,2017-08-04,2806.929932,2899.330078,2743.719971,2895.889893,2895.889893,1002120000.0,2740.7585622857155,59.44770490837576,30410847516.0,0.43837260310957893,0.11477509643493425
361,363,2017-08-05,2897.629883,3290.01001,2874.830078,3252.909912,3252.909912,1945699968.0,2772.386404785716,67.89957644775504,32356547484.0,0.4201250650804222,0.08177224628726253
362,364,2017-08-06,3257.610107,3293.290039,3155.600098,3213.939941,3213.939941,1105030016.0,2806.9249790000013,66.27584238030825,31251517468.0,0.4015773487029054,0.1338539540993942
363,365,2017-08-07,3212.780029,3397.679932,3180.889893,3378.939941,3378.939941,1482279936.0,2851.5021100000013,69.5915805564242,32733797404.0,0.44649848529808595,0.12390940435517642
364,366,2017-08-08,3370.219971,3484.850098,3345.830078,3419.939941,3419.939941,1752760064.0,2911.7492500714293,70.37112149593753,34486557468.0,0.3982204186650592,0.09846218445448526
365,367,2017-08-09,3420.399902,3422.76001,3247.669922,3342.469971,3342.469971,1468960000.0,2969.8221086428584,66.88221032177165,33017597468.0,0.45102268584785055,0.09611119317215082
366,368,2017-08-10,3341.840088,3453.449951,3319.469971,3381.280029,3381.280029,1515110016.0,3020.5006800714286,67.74496736481315,34532707484.0,0.4330293101066726,0.11659448458141279
367,369,2017-08-11,3373.820068,3679.719971,3372.1201170000004,3650.620117,3650.620117,2021190016.0,3080.615687714287,73.001589456175,36553897500.0,0.42531403802998885,0.0705238690192969
368,370,2017-08-12,3650.629883,3949.919922,3613.699951,3884.709961,3884.709961,2219589888.0,3163.348545571429,76.57480163340512,38773487388.0,0.4534689131235621,0.14400870855899323
369,371,2017-08-13,3880.040039,4208.3901369999985,3857.800049,4073.26001,4073.26001,3159089920.0,3257.3542654285725,78.98712162445129,41932577308.0,0.36309411231031247,0.042407842144678014
370,372,2017-08-14,4066.100098,4325.129883,3989.159912,4325.129883,4325.129883,2463089920.0,3360.910679357144,81.69840459202227,44395667228.0,0.42412693065849816,0.09173147537315436
371,373,2017-08-15,4326.990234000001,4455.970215,3906.179932,4181.930176,4181.930176,3258050048.0,3465.458548357144,75.71661569064473,41137617180.0,0.41128642991441167,0.10197683126269681
372,374,2017-08-16,4200.339844,4381.22998,3994.419922,4376.629883,4376.629883,2272039936.0,3584.455688428573,78.06790210531513,43409657116.0,0.4289288450030341,0.11663450541767384
373,375,2017-08-17,4384.439941,4484.700195,4243.709961,4331.689941,4331.689941,2553359872.0,3693.5242570714295,76.23308941670889,40856297244.0,0.4347860335635143,0.11082573984979095
374,376,2017-08-18,4324.339844,4370.129883,4015.399902,4160.620117,4160.620117,2941710080.0,3783.862130214287,69.53363067551908,37914587164.0,0.47531249923059093,0.09687518893959172
375,377,2017-08-19,4137.75,4243.259765999999,3970.550049,4193.700195,4193.700195,2975820032.0,3851.0614361428575,70.08117406903422,40890407196.0,0.4052084803783173,0.07961729214701362
376,378,2017-08-20,4189.310059,4196.290039,4069.879883,4087.659912,4087.659912,2109769984.0,3913.470005500001,65.98718677111549,38780637212.0,0.4474283625789139,0.10152763091653554
377,379,2017-08-21,4090.47998,4109.1401369999985,3988.600098,4001.73999,4001.73999,2800890112.0,3957.955723285716,62.78666898958496,35979747100.0,0.42137327962521937,0.08857143685277148
378,380,2017-08-22,3998.350098,4128.759765999999,3674.580078,4100.52002,4100.52002,3764239872.0,4006.5685860714293,64.89477458026171,39743986972.0,0.4110570888350133,0.09053536618963857
379,381,2017-08-23,4089.01001,4255.779785,4078.409912,4151.52002,4151.52002,2369819904.0,4064.357875285716,65.96674549307144,42113806876.0,0.4861050986050986,0.1436594783817006
380,382,2017-08-24,4137.600098,4376.3901369999985,4130.259765999999,4334.680176,4334.680176,2037750016.0,4132.457885785716,69.56157963434563,44151556892.0,0.40077413711472776,0.08244952037484739
381,383,2017-08-25,4332.819824,4455.700195,4307.350098,4371.600098,4371.600098,1727970048.0,4183.956455857145,70.24386545127523,45879526940.0,0.4479800118371366,0.09795556724869632
382,384,2017-08-26,4372.060059,4379.279785,4269.52002,4352.399902,4352.399902,1511609984.0,4217.3628802142875,69.37297382363681,44367916956.0,0.4101072990115586,0.07705391027536057
383,385,2017-08-27,4345.100098,4416.589844,4317.290039,4382.879883,4382.879883,1537459968.0,4239.478585428575,70.00866362526659,45905376924.0,0.412896216769521,0.07035623956206967
384,386,2017-08-28,4384.450195,4403.930176,4224.6401369999985,4382.660156,4382.660156,1959330048.0,4243.587890642859,69.99738449416698,43946046876.0,0.34484486178575846,0.06027681806418221
385,387,2017-08-29,4389.209961,4625.680176,4352.129883,4579.02002,4579.02002,2486080000.0,4271.951450928575,74.02488268873275,46432126876.0,0.3810524328993717,0.11061374757608375
386,388,2017-08-30,4570.3598630000015,4626.52002,4471.410156,4565.299805,4565.299805,1937849984.0,4285.427873928575,73.2846265884306,44494276892.0,0.39380384364099796,0.09755887106161772
387,389,2017-08-31,4555.589844,4736.049805,4549.399902,4703.3901369999985,4703.3901369999985,1944930048.0,4311.977887928574,75.89714736458322,46439206940.0,0.3898646568221716,0.06873407633793563
388,390,2017-09-01,4701.759765999999,4892.009765999999,4678.529785,4892.009765999999,4892.009765999999,2599079936.0,4364.220005714288,78.92829126483119,49038286876.0,0.39356061934735187,0.07704203124584154
389,391,2017-09-02,4901.419922,4975.040039,4469.240234000001,4578.77002,4578.77002,2722139904.0,4391.724993214288,64.43588317783657,46316146972.0,0.45880006367530174,0.11950020202020202
390,392,2017-09-03,4585.27002,4714.080078,4417.589844,4582.959961,4582.959961,1933190016.0,4427.103568142859,64.52970166443438,48249336988.0,0.3866434332930496,0.12035679154604986
391,393,2017-09-04,4591.629883,4591.629883,4108.399902,4236.310059,4236.310059,2987330048.0,4443.858573071429,52.24902165755787,45262006940.0,0.41400104568840423,0.08071127669092307
392,394,2017-09-05,4228.290039,4427.839844,3998.110107,4376.529785,4376.529785,2697969920.0,4463.573556285716,55.90462071180525,47959976860.0,0.3921078794170621,0.07805725336646879
393,395,2017-09-06,4376.589844,4617.25,4376.589844,4597.120117,4597.120117,2172100096.0,4495.402134642859,60.967160728523986,50132076956.0,0.4120316470211462,0.1397026256391564
394,396,2017-09-07,4589.1401369999985,4655.040039,4491.330078,4599.879883,4599.879883,1844620032.0,4514.344970857145,61.02744509939833,51976696988.0,0.3651872693161046,0.09619714887216974
395,397,2017-09-08,4605.160156,4661.0,4075.179932,4228.75,4228.75,2700890112.0,4504.1413924285725,49.872360629169734,49275806876.0,0.4340312944047302,0.10799564065671623
396,398,2017-09-09,4229.810059,4308.819824,4114.1098630000015,4226.060059,4226.060059,1386230016.0,4495.117117928573,49.80130640150837,47889576860.0,0.43399988607883344,0.08305209678235993
397,399,2017-09-10,4229.339844,4245.439941,3951.040039,4122.939941,4122.939941,1679090048.0,4476.549979214287,47.034782250805854,46210486812.0,0.41592527637098226,0.10642282109124643
398,400,2017-09-11,4122.470215,4261.669922,4099.399902,4161.27002,4161.27002,1557330048.0,4460.736398071429,48.186945251265534,47767816860.0,0.4575701157656045,0.08588360072311331
399,401,2017-09-12,4168.879883,4344.649902,4085.219971,4130.810059,4130.810059,1864530048.0,4428.7214008571445,47.30626922626261,45903286812.0,0.40609376008547515,0.0793203860771346
400,402,2017-09-13,4131.97998,4131.97998,3789.919922,3882.590088,3882.590088,2219409920.0,4379.95642107143,40.767540109263045,43683876892.0,0.439438296840243,0.08163157459560591
401,403,2017-09-14,3875.370117,3920.600098,3153.860107,3154.949951,3154.949951,2716310016.0,4269.353550642858,28.382649185985972,40967566876.0,0.41559084434987054,0.09695790921932608
402,404,2017-09-15,3166.300049,3733.449951,2946.6201170000004,3637.52002,3637.52002,4148069888.0,4179.7471402142855,41.15125071530881,45115636764.0,0.3986911731777351,0.1343179787589017
403,405,2017-09-16,3637.75,3808.840088,3487.790039,3625.040039,3625.040039,1818400000.0,4111.623570142859,40.94792364980909,43297236764.0,0.42558914478623466,0.1238494359965921
404,406,2017-09-17,3606.280029,3664.810059,3445.639893,3582.879883,3582.879883,1239149952.0,4040.189278857145,40.224854874181354,42058086812.0,0.4211429906165803,0.15471545263290307
405,407,2017-09-18,3591.090088000001,4079.22998,3591.090088000001,4065.199951,4065.199951,1943209984.0,4027.9671282857157,50.90551787693399,44001296796.0,0.37891805786731236,0.09035617397042935
406,408,2017-09-19,4073.790039,4094.070068,3868.870117,3924.969971,3924.969971,1563980032.0,3995.712855857144,48.20845536147651,42437316764.0,0.4166889318881312,0.11022176430757225
407,409,2017-09-20,3916.360107,4031.389893,3857.72998,3905.949951,3905.949951,1213830016.0,3946.343558285716,47.83823856886669,41223486748.0,0.4327603252264711,0.12789844501563252
408,410,2017-09-21,3901.469971,3916.419922,3613.629883,3631.040039,3631.040039,1411480064.0,3877.140712285716,42.73043355975992,39812006684.0,0.3930932383510256,0.08515362799838001
409,411,2017-09-22,3628.02002,3758.27002,3553.530029,3630.699951,3630.699951,1194829952.0,3834.422851642859,42.72435612579718,38617176732.0,0.42836326501748057,0.11262568425431549
410,412,2017-09-23,3629.919922,3819.209961,3594.580078,3792.399902,3792.399902,928113984.0,3803.4471261428585,46.61236206099329,39545290716.0,0.37588602450223957,0.08072999249989138
411,413,2017-09-24,3796.149902,3796.149902,3666.899902,3682.840088,3682.840088,768014976.0,3772.011422357144,44.412534792214814,38777275740.0,0.4282419961867805,0.11848022379438551
412,414,2017-09-25,3681.580078,3950.25,3681.580078,3926.070068,3926.070068,1374210048.0,3755.2114257857147,50.048712267050746,40151485788.0,0.4614139911212055,0.11323581426630452
413,415,2017-09-26,3928.409912,3969.889893,3869.899902,3892.350098,3892.350098,1043740032.0,3738.178571428573,49.30238302264402,39107745756.0,0.3987447523912013,0.1047496010849104
414,416,2017-09-27,3892.939941,4210.049805,3884.820068,4200.669922,4200.669922,1686880000.0,3760.8985595714294,55.79354171454684,40794625756.0,0.40152485658968573,0.10597454621437566
415,417,2017-09-28,4197.129883,4279.310059,4109.700195,4174.72998,4174.72998,1712320000.0,3833.739990214287,55.15371599494846,39082305756.0,0.4184009757749254,0.0883325509691056
416,418,2017-09-29,4171.620117,4214.629883,4039.290039,4163.069824,4163.069824,1367049984.0,3871.279261928573,54.84922928892668,37715255772.0,0.394225258975817,0.10161529408164335
417,419,2017-09-30,4166.1098630000015,4358.430176,4160.8598630000015,4338.709961,4338.709961,1207449984.0,3922.255684928573,58.56041780242344,38922705756.0,0.4007948666303386,0.08739396221537395
418,420,2017-10-01,4341.049805,4403.740234000001,4269.810059,4403.740234000001,4403.740234000001,1208210048.0,3980.8885671428584,59.87544451497883,40130915804.0,0.4481017343609304,0.09002824066202353
419,421,2017-10-02,4395.810059,4470.22998,4377.459961,4409.319824,4409.319824,1431730048.0,4005.468558071429,59.9927529573239,41562645852.0,0.4648223257482969,0.13334265467072712
420,422,2017-10-03,4408.459961,4432.470215,4258.8901369999985,4317.47998,4317.47998,1288019968.0,4033.504987285715,57.036863407699045,40274625884.0,0.4463161128415647,0.07798142382501833
421,423,2017-10-04,4319.370117,4352.310059,4210.419922,4229.3598630000015,4229.3598630000015,1116770048.0,4056.6056952857134,54.27369465636063,39157855836.0,0.3821498758357062,0.0878157718450219
422,424,2017-10-05,4229.879883,4362.6401369999985,4164.049805,4328.410156,4328.410156,1161769984.0,4106.4178465,56.806685878291766,40319625820.0,0.41988885084113964,0.06022126798410294
423,425,2017-10-06,4324.459961,4413.27002,4320.529785,4370.810059,4370.810059,1069939968.0,4159.282854214286,57.88222635871657,41389565788.0,0.4402424619200322,0.09105566459599033
424,426,2017-10-07,4369.350098,4443.879883,4321.049805,4426.8901369999985,4426.8901369999985,906928000.0,4204.603585285715,59.32489741637066,42296493788.0,0.45162313295873907,0.0796719871811833
425,427,2017-10-08,4429.669922,4624.1401369999985,4405.6401369999985,4610.47998,4610.47998,1313869952.0,4270.863577571429,63.7076029433137,43610363740.0,0.4317139173843912,0.10478092408258172
426,428,2017-10-09,4614.52002,4878.709961,4564.25,4772.02002,4772.02002,1968739968.0,4331.288574142857,67.06980743431981,45579103708.0,0.41516652314646624,0.08937959097004129
427,429,2017-10-10,4776.209961,4922.169922,4765.100098,4781.990234000001,4781.990234000001,1597139968.0,4394.834298142857,67.2713402021356,47176243676.0,0.42238742822590203,0.09701463004679775
428,430,2017-10-11,4789.25,4873.72998,4751.629883,4826.47998,4826.47998,1222279936.0,4439.535016571428,68.2063829529306,48398523612.0,0.4406925852437983,0.11296088076217072
429,431,2017-10-12,4829.580078,5446.910156,4822.0,5446.910156,5446.910156,2791610112.0,4530.405029142857,77.75212125994831,51190133724.0,0.4457859633143321,0.1213443040780142
430,432,2017-10-13,5464.160156,5840.299805,5436.850098,5647.209961,5647.209961,3615480064.0,4636.41503892857,79.85497774500402,54805613788.0,0.44916483912042976,0.10428072750254673
431,433,2017-10-14,5643.529785,5837.700195,5591.6401369999985,5831.790039,5831.790039,1669030016.0,4743.063615928571,81.58256195147304,56474643804.0,0.45084200644396266,0.11271991674429079
432,434,2017-10-15,5835.959961,5852.47998,5478.6098630000015,5678.189941,5678.189941,1976039936.0,4834.095737857143,75.76014102714416,54498603868.0,0.41579382237853985,0.07252404874746626
433,435,2017-10-16,5687.569824,5776.22998,5544.209961,5725.589844,5725.589844,2008070016.0,4928.115025,76.32174048418318,56506673884.0,0.41237988183910507,0.1206196265343605
434,436,2017-10-17,5741.580078,5800.350098,5472.720215,5605.509765999999,5605.509765999999,1821570048.0,5020.117152571429,71.78436573652839,54685103836.0,0.462822731597687,0.07674536976891266
435,437,2017-10-18,5603.819824,5603.819824,5151.439941,5590.689941,5590.689941,2399269888.0,5117.355015285714,71.22160352360666,52285833948.0,0.42775452170471256,0.07276419581707008
436,438,2017-10-19,5583.740234000001,5744.350098,5531.060059,5708.52002,5708.52002,1780540032.0,5215.934291285715,73.03187453994309,54066373980.0,0.4101116650441728,0.1304269553153388
437,439,2017-10-20,5708.1098630000015,6060.1098630000015,5627.22998,6011.450195,6011.450195,2354429952.0,5333.122872428571,77.03198135837766,56420803932.0,0.42147431679817404,0.06441171251906636
438,440,2017-10-21,5996.790039,6194.879883,5965.069824,6031.600098,6031.600098,2207099904.0,5447.745012500001,77.2734547919637,58627903836.0,0.4359849795291653,0.06868206963747542
439,441,2017-10-22,6036.660156,6076.259765999999,5792.339844,6008.419922,6008.419922,2034630016.0,5547.5978655,76.27991677718488,56593273820.0,0.4171136210316913,0.1170199284962655
440,442,2017-10-23,6006.0,6075.589844,5732.470215,5930.319824,5930.319824,2401840128.0,5630.333565785715,72.87989700460625,54191433692.0,0.4469987339215197,0.07146075752039756
441,443,2017-10-24,5935.52002,5935.52002,5504.180176,5526.6401369999985,5526.6401369999985,2735699968.0,5683.522844571429,58.392287755945176,51455733724.0,0.4367800434029364,0.07170665758865712
442,444,2017-10-25,5524.600098,5754.330078,5397.879883,5750.799805,5750.799805,1966989952.0,5749.545689214286,62.8129375247123,53422723676.0,0.3994673575134398,0.09432202068753225
443,445,2017-10-26,5747.950195,5976.799805,5721.220215,5904.830078,5904.830078,1905040000.0,5782.25425507143,65.52355389559425,55327763676.0,0.4550171441048159,0.11181417262660327
444,446,2017-10-27,5899.740234000001,5988.3901369999985,5728.819824,5780.899902,5780.899902,1710130048.0,5791.8035365714295,61.63103011148787,53617633628.0,0.4171675785767596,0.10872026281349334
445,447,2017-10-28,5787.819824,5876.720215,5689.189941,5753.089844,5753.089844,1403920000.0,5786.18209407143,60.75875752105046,52213713628.0,0.4180575142136866,0.08968522843360092
446,448,2017-10-29,5754.439941,6255.709961,5724.580078,6153.850098,6153.850098,2859040000.0,5820.157819571429,67.82567040272461,55072753628.0,0.39098796940271463,0.061398322955324026
447,449,2017-10-30,6114.850098,6214.990234000001,6040.850098,6130.529785,6130.529785,1772150016.0,5849.08210107143,67.06876481531063,53300603612.0,0.39432256051724357,0.09769865767989455
448,450,2017-10-31,6132.02002,6470.430176,6103.330078,6468.399902,6468.399902,2311379968.0,5910.717110785716,71.95240189273369,55611983580.0,0.4107008327766552,0.09952658764065068
449,451,2017-11-01,6440.970215,6767.310059,6377.879883,6767.310059,6767.310059,2870320128.0,5994.76140492857,75.42464928197151,58482303708.0,0.4475274085796788,0.13867256435292846
450,452,2017-11-02,6777.77002,7367.330078,6758.720215,7078.5,7078.5,4653770240.0,6092.617117785715,78.41992917355863,63136073948.0,0.4354943607048617,0.11282980363530545
451,453,2017-11-03,7087.529785,7461.290039,7002.939941,7207.759765999999,7207.759765999999,3369860096.0,6178.067801428571,79.53565633427033,66505934044.0,0.3830289444733189,0.0893063960145764
452,454,2017-11-04,7164.47998,7492.859863,7031.279785,7379.950195,7379.950195,2483800064.0,6274.378522642858,80.94871362777816,68989734108.0,0.4562769180431074,0.12087460376997915
453,455,2017-11-05,7404.52002,7617.47998,7333.189941,7407.410156,7407.410156,2380410112.0,6374.306396500001,81.1719895910434,71370144220.0,0.45440478712122967,0.09393778614964539
454,456,2017-11-06,7403.220215,7445.77002,7007.310059,7022.759765999999,7022.759765999999,3111899904.0,6452.337820928572,68.97720332941451,68258244316.0,0.423229722746969,0.1260933888473286
455,457,2017-11-07,7023.100098000001,7253.319823999998,7023.100098000001,7144.379883,7144.379883,2326340096.0,6567.890659928572,70.48695640929427,70584584412.0,0.4442447707355808,0.06618030238571695
456,458,2017-11-08,7141.379883,7776.419922,7114.02002,7459.689941,7459.689941,4602200064.0,6689.954241071429,74.01736707532902,75186784476.0,0.42377983682104076,0.10056219720909701
457,459,2017-11-09,7446.830078,7446.830078,7101.52002,7143.580078,7143.580078,3226249984.0,6778.436383928573,65.55137360207314,71960534492.0,0.4465407286794606,0.08057393156883157
458,460,2017-11-10,7173.72998,7312.0,6436.870117,6618.1401369999985,6618.1401369999985,5208249856.0,6838.2392578571435,54.410979383916825,66752284636.0,0.43252578263168756,0.10549905888696523
459,461,2017-11-11,6618.6098630000015,6873.149901999999,6204.220215,6357.600098,6357.600098,4908680192.0,6881.418561714286,49.88392745284943,61843604444.0,0.42942699746011775,0.07864480599138922
460,462,2017-11-12,6295.450195,6625.049805,5519.009765999999,5950.069824,5950.069824,8957349888.0,6866.862827857143,43.75200097050793,52886254556.0,0.4187281574577502,0.09273562803559814
461,463,2017-11-13,5938.25,6811.189941,5844.290039,6559.490234000001,6559.490234000001,6263249920.0,6897.5028599285715,53.04685885529653,59149504476.0,0.4016477439264443,0.12140002525436078
462,464,2017-11-14,6561.47998,6764.97998,6461.75,6635.75,6635.75,3197110016.0,6909.456438357142,54.06967679030361,62346614492.0,0.44519912420900065,0.08846136742228428
463,465,2017-11-15,6634.759765999999,7342.25,6634.759765999999,7315.540039,7315.540039,4200880128.0,6948.615722642857,62.01346073860121,66547494620.0,0.41947002004818823,0.07454098549015091
464,466,2017-11-16,7323.240234000001,7967.379883,7176.580078,7871.689941,7871.689941,5123809792.0,7005.2721470000015,67.03646406388953,71671304412.0,0.42958869378875963,0.0953208009419692
465,467,2017-11-17,7853.569823999998,8004.589844,7561.089844,7708.990234000001,7708.990234000001,4651670016.0,7041.074323285714,64.35545257893999,67019634396.0,0.41990286093377965,0.0893770012947612
466,468,2017-11-18,7697.209961,7884.990234000001,7463.439941,7790.149901999999,7790.149901999999,3667190016.0,7070.374302357143,65.10515180643401,70686824412.0,0.41714433619306573,0.12242006832904698
467,469,2017-11-19,7766.029785,8101.910156,7694.100098000001,8036.490234000001,8036.490234000001,3149319936.0,7115.308593642856,67.34985544664667,73836144348.0,0.4371046004810978,0.06482000375153693
468,470,2017-11-20,8039.069823999998,8336.860352,7949.359863,8200.639648,8200.639648,3488450048.0,7199.44287092857,68.79055125604577,77324594396.0,0.4323297061521711,0.08509231234860301
469,471,2017-11-21,8205.740234,8348.660156,7762.709961,8071.259765999999,8071.259765999999,4277609984.0,7265.648576857144,66.30707973963645,73046984412.0,0.40545975453779776,0.08164121372275158
470,472,2017-11-22,8077.950195,8302.259766,8075.470215,8253.549805,8253.549805,3633530112.0,7322.352852857142,68.05688045953879,76680514524.0,0.44697554435808723,0.09320260304269873
471,473,2017-11-23,8232.379883,8267.400391,8038.77002,8038.77002,8038.77002,4225179904.0,7386.294991571428,63.84940183267491,72455334620.0,0.43161838501844,0.07714801153104393
472,474,2017-11-24,8074.02002,8374.160156,7940.930176000002,8253.69043,8253.69043,5058610176.0,7503.1200125,66.10740059297021,77513944796.0,0.3827487924207734,0.09619685383967566
473,475,2017-11-25,8241.709961,8790.919922,8191.149901999999,8790.919922,8790.919922,4342060032.0,7676.928571357143,70.9858800680774,81856004828.0,0.46628422690149307,0.09502642693215248
474,476,2017-11-26,8789.040039,9522.929688,8775.589844,9330.549805,9330.549805,5475579904.0,7918.3914271428575,74.89485719156609,87331584732.0,0.49290436402699317,0.08279873904915876
475,477,2017-11-27,9352.719727,9818.349609,9352.719727,9818.349609,9818.349609,5653320192.0,8151.167096785714,77.80573993146278,92984904924.0,0.4058138789773344,0.07513557501119478
476,478,2017-11-28,9823.429688,10125.700195,9736.299805,10058.799805,10058.799805,6348819968.0,8395.670654285717,79.09259697277078,99333724892.0,0.4338028374315305,0.09828976219569692
477,479,2017-11-29,10077.400391,11517.400391,9601.030273,9888.610352,9888.610352,11568799744.0,8579.461390928573,75.74498061244748,87764925148.0,0.4449895220015714,0.07465554751933548
478,480,2017-11-30,9906.790039,10801.0,9202.049805,10233.599609,10233.599609,8310689792.0,8748.169224357143,77.79651414726924,96075614940.0,0.40585055609880205,0.09196315064839634
479,481,2017-12-01,10198.599609,11046.700195,9694.650391,10975.599609,10975.599609,6783119872.0,8981.49846542857,81.43383923711569,102858734812.0,0.38293451044929633,0.06931746382906091
480,482,2017-12-02,10978.299805,11320.200195,10905.099609,11074.599609,11074.599609,5138500096.0,9216.10201592857,81.86080681227887,107997234908.0,0.39642947563431064,0.09330201018879772
481,483,2017-12-03,11082.700195,11858.700195,10862.0,11323.200195,11323.200195,6608309760.0,9450.867013142857,82.92284456831838,114605544668.0,0.4185923811250798,0.0874263100980496
482,484,2017-12-04,11315.400391,11657.200195,11081.799805,11657.200195,11657.200195,6132409856.0,9697.76419507143,84.256524468265,120737954524.0,0.4160387428412149,0.0523925113120921
483,485,2017-12-05,11685.700195,12032.0,11604.599609,11916.700195,11916.700195,6895260160.0,9972.438511428572,85.22217956812209,127633214684.0,0.4535228340521287,0.10123870245066902
484,486,2017-12-06,11923.400391,14369.099609,11923.400391,14291.5,14291.5,12656300032.0,10403.720668214288,90.78976158289422,140289514716.0,0.5045116274707581,0.13959634607977772
485,487,2017-12-07,14266.099609,17899.699219,14057.299805,17899.699219,17899.699219,17950699520.0,11108.072753857146,94.30221454695265,158240214236.0,0.4460530602152853,0.10985246802353181
486,488,2017-12-08,17802.900391,18353.400391,14336.900391,16569.400391,16569.400391,21135998976.0,11702.05203678572,81.90080130885269,137104215260.0,0.43643434036945056,0.08336588997363756
487,489,2017-12-09,16523.300781,16783.0,13674.900391,15178.200195,15178.200195,13911300096.0,12158.286342000005,71.33553781768637,123192915164.0,0.4372298068730231,0.06737466498454144
488,490,2017-12-10,15168.400391,15850.599609,13226.599609,15455.400391,15455.400391,13433299968.0,12595.775669571432,72.10762486284041,136626215132.0,0.4444436538144781,0.10918340243566102
489,491,2017-12-11,15427.400391,17513.900391,15404.799805,16936.800781,16936.800781,12153900032.0,13104.236467571433,75.85116323161306,148780115164.0,0.4543412680442665,0.13383360187680243
490,492,2017-12-12,16919.800781,17781.800781,16571.599609,17415.400391,17415.400391,14603799552.0,13629.707938000007,76.92851353112047,163383914716.0,0.43277548957259754,0.10212007128161615
491,493,2017-12-13,17500.0,17653.099609,16039.700195,16408.199219,16408.199219,12976900096.0,14095.392857071436,69.86458391801436,150407014620.0,0.4389429546800139,0.11058330220488949
492,494,2017-12-14,16384.599609,17085.800781,16185.900391,16564.0,16564.0,13777399808.0,14547.564313571436,70.31861056327007,164184414428.0,0.44186748646783286,0.11143492480517266
493,495,2017-12-15,16601.300781,18154.099609,16601.300781,17706.900391,17706.900391,14309999616.0,15028.371512285725,73.47560014844385,178494414044.0,0.4502153005125454,0.10432351107622322
494,496,2017-12-16,17760.300781,19716.699219,17515.300781,19497.400391,19497.400391,12740599808.0,15630.000139571435,77.51118214889925,191235013852.0,0.41106063501276335,0.08876075744130184
495,497,2017-12-17,19475.800781,20089.0,18974.099609,19140.800781,19140.800781,13314599936.0,16188.400181428578,75.06172212439806,177920413916.0,0.46805155452105957,0.0919850737632457
496,498,2017-12-18,19106.400391,19371.0,18355.900391,19114.199219,19114.199219,14839499776.0,16721.04296885715,74.87164304614217,163080914140.0,0.43958323669333565,0.1082292458843852
497,499,2017-12-19,19118.300781,19177.800781,17275.400391,17776.699219,17776.699219,16894499840.0,17139.61432771429,65.84347064896771,146186414300.0,0.42609033808588465,0.08342743023774894
498,500,2017-12-20,17760.300781,17934.699219,16077.700195,16624.599609,16624.599609,22149699584.0,17306.264299785722,59.2193664017966,124036714716.0,0.419031321071864,0.10083216054668619
499,501,2017-12-21,16642.400391,17567.699219,15342.700195,15802.900391,15802.900391,16516599808.0,17156.492954928577,54.97160251080199,107520114908.0,0.41003233811853135,0.08643243037990288
500,502,2017-12-22,15898.0,15943.400391,11833.0,13831.799805,13831.799805,22197999616.0,16960.950055928577,46.37776689050124,85322115292.0,0.45588312713471824,0.0799411725573553
501,503,2017-12-23,13948.700195,15603.200195,13828.799805,14699.200195,14699.200195,13086000128.0,16926.73577021429,50.076469744434796,98408115420.0,0.4330641999449923,0.11366504835543433
502,504,2017-12-24,14608.200195,14626.0,12747.700195,13925.799805,13925.799805,11572299776.0,16817.478585500005,46.965787757831755,86835815644.0,0.43839879423165035,0.10000770689548545
503,505,2017-12-25,13995.900391,14593.0,13448.900391,14026.599609,14026.599609,10664699904.0,16609.60707321429,47.42419118550044,97500515548.0,0.4324044054323657,0.08902610677719901
504,506,2017-12-26,14036.599609,16461.199219,14028.900391,16099.799805,16099.799805,13454300160.0,16515.63560278572,55.87245941395327,110954815708.0,0.42918324271714814,0.11709649854883025
505,507,2017-12-27,16163.5,16930.900391,15114.299805,15838.5,15838.5,12487600128.0,16474.942801428573,54.67986789656706,98467215580.0,0.43396151176674985,0.0966641170826458
506,508,2017-12-28,15864.099609,15888.400391,13937.299805,14606.5,14606.5,12336499712.0,16335.121372857146,49.333129905210285,86130715868.0,0.469146188419788,0.09708875048722669
507,509,2017-12-29,14695.799805,15279.0,14307.0,14656.200195,14656.200195,13025500160.0,16117.214216000006,49.54745675348561,99156216028.0,0.40445561529135904,0.11035087244990374
508,510,2017-12-30,14681.900391,14681.900391,12350.099609,12952.200195,12952.200195,14452599808.0,15649.699916285717,42.85413882855156,84703616220.0,0.41648402864951467,0.09466945216620802
509,511,2017-12-31,12897.700195,14377.400391,12755.599609,14156.400391,14156.400391,12136299520.0,15293.671317000006,48.181573073064776,96839915740.0,0.43775216837773745,0.09357152513589413
510,512,2018-01-01,14112.200195,14112.200195,13154.700195,13657.200195,13657.200195,10291200000.0,14903.885672428576,46.25641657852341,86548715740.0,0.42996879388555,0.0953735499906692
511,513,2018-01-02,13625.0,15444.599609,13163.599609,14982.099609,14982.099609,16846600192.0,14704.271414571433,51.76500295935285,103395315932.0,0.4009900893413111,0.08462235373358032
512,514,2018-01-03,14978.200195,15572.799805,14844.5,15201.0,15201.0,16871900160.0,14602.585728214292,52.62892606058257,120267216092.0,0.4208608068767813,0.08613640958462299
513,515,2018-01-04,15270.700195,15739.700195,14522.200195,15599.200195,15599.200195,21783199744.0,14588.035714214291,54.23471555162461,142050415836.0,0.42487617198357575,0.08274864010892291
514,516,2018-01-05,15477.200195,17705.199219,15202.799805,17429.5,17429.5,23840899072.0,14845.014299571436,60.81053867672686,165891314908.0,0.3961575509426829,0.09605036564658936
515,517,2018-01-06,17462.099609,17712.400391,16764.599609,17527.0,17527.0,18314600448.0,15046.999999928577,61.130933238667204,184205915356.0,0.45375453395521065,0.0869396546466228
516,518,2018-01-07,17527.300781,17579.599609,16087.700195,16477.599609,16477.599609,15866000384.0,15229.271414500005,55.839440664801295,168339914972.0,0.379469969181447,0.08881944622661611
517,519,2018-01-08,16476.199219,16537.900391,14208.200195,15170.099609,15170.099609,18413899776.0,15310.949985928577,50.02881928557192,149926015196.0,0.38720260139159607,0.07494151981836827
518,520,2018-01-09,15123.700195,15497.5,14424.0,14595.400391,14595.400391,16659999744.0,15203.492884928579,47.680248674045394,133266015452.0,0.39694812313246497,0.08837857375324679
519,521,2018-01-10,14588.5,14973.299805,13691.200195,14973.299805,14973.299805,18500800512.0,15141.692871000007,49.36356894241764,151766815964.0,0.39825676274365013,0.07716200489306037
520,522,2018-01-11,14968.200195,15018.799805,13105.900391,13405.799805,13405.799805,16534099968.0,15055.928571357148,43.160538025520744,135232715996.0,0.42724622573643645,0.055282361739797774
521,523,2018-01-12,13453.900391,14229.900391,13158.099609,13980.599609,13980.599609,12065699840.0,15007.671386642862,45.84778371788525,147298415836.0,0.4318040661955391,0.07128456404386525
522,524,2018-01-13,13952.400391,14659.5,13952.400391,14360.200195,14360.200195,12763599872.0,15108.242815214291,47.609378101273535,160062015708.0,0.4351855328357062,0.09535673320376133
523,525,2018-01-14,14370.799805,14511.799805,13268.0,13772.0,13772.0,11084099584.0,15080.785644428577,45.158015784616936,148977916124.0,0.4582546262176818,0.08891433261538526
524,526,2018-01-15,13767.299805,14445.5,13641.700195,13819.799805,13819.799805,12750799872.0,15092.399902285715,45.40403057810875,161728715996.0,0.413016098859346,0.0959343931850321
525,527,2018-01-16,13836.099609,13843.099609,10194.900391,11490.5,11490.5,18853799936.0,14842.999930214288,36.75208152078389,142874916060.0,0.4039435292861904,0.09834055358192208
526,528,2018-01-17,11431.099609,11678.0,9402.290039,11188.599609,11188.599609,18830600192.0,14556.399902285715,35.799890219702135,124044315868.0,0.4345199915972037,0.1044378635564991
527,529,2018-01-18,11198.799805,12107.299805,10942.5,11474.900391,11474.900391,15020399616.0,14261.807059142859,37.45482031980486,139064715484.0,0.4301692885657107,0.10283831103770821
528,530,2018-01-19,11429.799805,11992.799805,11172.099609,11607.400391,11607.400391,10740400128.0,13845.942801357143,38.24818279302372,149805115612.0,0.44620834688734906,0.09243643509301247
529,531,2018-01-20,11656.200195,13103.0,11656.200195,12899.200195,12899.200195,11801700352.0,13515.385672428574,45.50577127422026,161606815964.0,0.4066813630716657,0.08350098150327863
530,532,2018-01-21,12889.200195,12895.900391,11288.200195,11600.099609,11600.099609,9935179776.0,13166.992815285716,40.367608421162636,151671636188.0,0.3938953885734039,0.10649109623448015
531,533,2018-01-22,11633.099609,11966.400391,10240.200195,10931.400391,10931.400391,10537400320.0,12864.228585428576,37.98977809189167,141134235868.0,0.41109124401473013,0.06112637479024918
532,534,2018-01-23,10944.5,11377.599609,10129.700195,10868.400391,10868.400391,9660609536.0,12598.014299714287,37.76408347111596,131473626332.0,0.3763920980177534,0.10876834818191898
533,535,2018-01-24,10903.400391,11501.400391,10639.799805,11359.400391,11359.400391,9940989952.0,12339.87862728572,40.71997475837055,141414616284.0,0.4517142177360907,0.07750571834452276
534,536,2018-01-25,11421.700195,11785.700195,11057.400391,11259.400391,11259.400391,8873169920.0,12186.564383428577,40.30016035640668,132541446364.0,0.4473675835114607,0.10187601463857988
535,537,2018-01-26,11256.0,11656.700195,10470.299805,11171.400391,11171.400391,9746199552.0,11985.907296428577,39.91021722031141,122795246812.0,0.42228556092003694,0.07875258976895715
536,538,2018-01-27,11174.900391,11614.900391,10989.200195,11440.700195,11440.700195,7583269888.0,11777.371582142863,41.76716830403677,130378516700.0,0.4427499662082498,0.07457780487834129
537,539,2018-01-28,11475.299805,12040.299805,11475.299805,11786.299805,11786.299805,8350360064.0,11635.535853928577,44.152377150443144,138728876764.0,0.40206264877257214,0.10376355931155919
538,540,2018-01-29,11755.5,11875.599609,11179.200195,11296.400391,11296.400391,7107359744.0,11455.293038642863,41.554070335192215,131621517020.0,0.4336180073672762,0.12520445489808207
539,541,2018-01-30,11306.799805,11307.200195,10036.200195,10106.299805,10106.299805,8637859840.0,11356.421596142862,36.01008668418014,122983657180.0,0.41621242783556167,0.06875327769968143
540,542,2018-01-31,10108.200195,10381.599609,9777.419922,10221.099609,10221.099609,8041160192.0,11287.31445328572,36.884837261174944,131024817372.0,0.41670767422946414,0.10612655611311239
541,543,2018-02-01,10237.299805,10288.799805,8812.280273,9170.540039,9170.540039,9959400448.0,11122.717285285718,32.50562979288623,121065416924.0,0.4389226236082333,0.11611934911848307
542,544,2018-02-02,9142.280273,9142.280273,7796.490234000001,8830.75,8830.75,12726899712.0,10924.385114500004,31.21476041558316,108338517212.0,0.4172105105751132,0.07086650021180162
543,545,2018-02-03,8852.120117,9430.75,8251.629883,9174.910156,9174.910156,7263790080.0,10658.364397428575,34.07062305483808,115602307292.0,0.39892057649152957,0.08336443808085589
544,546,2018-02-04,9175.700195,9334.870117,8031.220215,8277.009766,8277.009766,7073549824.0,10421.000837214291,30.511390870298587,108528757468.0,0.42323653449147763,0.0964194080251141
545,547,2018-02-05,8270.540039,8364.839844,6756.680176000002,6955.27002,6955.27002,9285289984.0,10136.991525000003,26.176396158687268,99243467484.0,0.3993359985396413,0.10888181681205236
546,548,2018-02-06,7051.75,7850.700195,6048.259765999999,7754.0,7754.0,13999800320.0,9914.534354214291,32.424583161461946,113243267804.0,0.4391894837210263,0.10172356839124114
547,549,2018-02-07,7755.490234000001,8509.110352,7236.790039,7621.299805,7621.299805,9169280000.0,9647.5271695,31.940898665851265,104073987804.0,0.44433214321152725,0.09634861381330397
548,550,2018-02-08,7637.859863,8558.769531,7637.859863,8265.589844,8265.589844,9346750464.0,9433.683559,36.86526828636316,113420738268.0,0.4114325465981878,0.07238718649380335
549,551,2018-02-09,8271.839844,8736.980469,7884.709961,8736.980469,8736.980469,6784820224.0,9259.796421714289,40.270432129024094,120205558492.0,0.40985431420142615,0.08491690885715686
550,552,2018-02-10,8720.080078,9122.549805,8295.469727,8621.900391,8621.900391,7780960256.0,9058.453578571429,39.70738486926465,112424598236.0,0.40725893790636836,0.07985793503139599
551,553,2018-02-11,8616.129883,8616.129883,7931.100098000001,8129.970215,8129.970215,6122189824.0,8797.287179285715,37.30618974024088,106302408412.0,0.4238243771464562,0.09605386004157113
552,554,2018-02-12,8141.430176000002,8985.919922,8141.430176000002,8926.570313,8926.570313,6256439808.0,8628.013602285715,43.287004233026884,112558848220.0,0.44887551535144704,0.08100387796898313
553,555,2018-02-13,8926.719727,8958.469727,8455.410156,8598.30957,8598.30957,5696719872.0,8520.300014071428,41.528881547378624,106862128348.0,0.4160880814753337,0.05860650426970389
554,556,2018-02-14,8599.919922,9518.540039,8599.919922,9494.629883,9494.629883,7909819904.0,8468.409319357144,47.76715364894188,114771948252.0,0.3962361457975738,0.07802145547014173
555,557,2018-02-15,9488.320313,10234.799805,9395.580078,10166.400391,10166.400391,9062540288.0,8539.542201642858,51.90843029698715,123834488540.0,0.42551338847345094,0.08540222240896594
556,558,2018-02-16,10135.700195,10324.099609,9824.820313,10233.900391,10233.900391,7296159744.0,8639.76722957143,52.31751846873872,131130648284.0,0.4288134732938659,0.06829439700872901
557,559,2018-02-17,10207.5,11139.5,10149.400391,11112.700195,11112.700195,8660880384.0,8778.180803785715,57.39845930261491,139791528668.0,0.4350876263900913,0.09740616734580705
558,560,2018-02-18,11123.400391,11349.799805,10326.0,10551.799805,10551.799805,8744009728.0,8940.66580657143,53.48132954818464,131047518940.0,0.411571182794964,0.09462685938400606
559,561,2018-02-19,10552.599609,11273.799805,10513.200195,11225.299805,11225.299805,7652089856.0,9245.667934071429,57.25360788254515,138699608796.0,0.41811060298973857,0.09176256378708172
560,562,2018-02-20,11231.799805,11958.5,11231.799805,11403.700195,11403.700195,9926540288.0,9506.360805142858,58.22007476507879,148626149084.0,0.4066003446945709,0.06391277210105147
561,563,2018-02-21,11372.200195,11418.5,10479.099609,10690.400391,10690.400391,9405339648.0,9725.582275571429,53.055019435669315,139220809436.0,0.4357692611088953,0.09703171856125621
562,564,2018-02-22,10660.400391,11039.099609,9939.089844,10005.0,10005.0,8040079872.0,9849.825858142858,48.59392774599053,131180729564.0,0.3830482300276276,0.07691313496775834
563,565,2018-02-23,9937.070313,10487.299805,9734.55957,10301.099609,10301.099609,7739500032.0,9961.548653857144,50.52919873158309,138920229596.0,0.427527707689506,0.0608450307840526
564,566,2018-02-24,10287.700195,10597.200195,9546.969727,9813.070313,9813.070313,6917929984.0,10046.632219714289,47.36422205234029,132002299612.0,0.43203195604182,0.09468269288419522
565,567,2018-02-25,9796.419922,9923.219727,9407.05957,9664.730469,9664.730469,5706939904.0,10156.257952142858,46.41260834932595,126295359708.0,0.422229753044286,0.08805027714964189
566,568,2018-02-26,9669.429688,10475.0,9501.730469,10366.700195,10366.700195,7287690240.0,10259.124372285716,51.389785140989744,133583049948.0,0.4116533941455006,0.0907664456654614
567,569,2018-02-27,10393.900391,10878.5,10246.099609,10725.599609,10725.599609,6966179840.0,10411.073660785714,53.75476004289471,140549229788.0,0.3815267536693793,0.08186253722774009
568,570,2018-02-28,10687.200195,11089.799805,10393.099609,10397.900391,10397.900391,6936189952.0,10475.592982785716,51.300568190776694,133613039836.0,0.431971393682808,0.10861184388152588
569,571,2018-03-01,10385.0,11052.299805,10352.700195,10951.0,10951.0,7317279744.0,10531.635812000002,55.032256065737904,140930319580.0,0.3780365437656691,0.06933743140049943
570,572,2018-03-02,10977.400391,11189.0,10850.099609,11086.400391,11086.400391,7620590080.0,10592.52866914286,55.922682055962476,148550909660.0,0.3869213600852163,0.08027059538127178
571,573,2018-03-03,11101.900391,11528.200195,11002.400391,11489.700195,11489.700195,6690570240.0,10619.45724057143,58.5551328176621,155241479900.0,0.4222858277471587,0.08811676565596548
572,574,2018-03-04,11497.400391,11512.599609,11136.099609,11512.599609,11512.599609,6084149760.0,10688.085798000002,58.7059371271284,161325629660.0,0.4073861928596191,0.08275076645013435
573,575,2018-03-05,11532.400391,11704.099609,11443.900391,11573.299805,11573.299805,6468539904.0,10712.942940857143,59.130452321570004,167794169564.0,0.45316418204071707,0.09233610435164165
574,576,2018-03-06,11500.099609,11500.099609,10694.299805,10779.900391,10779.900391,6832169984.0,10668.385812000002,51.65549650049201,160961999580.0,0.43597071637896906,0.08884166953657975
575,577,2018-03-07,10803.900391,10929.5,9692.120117,9965.570313,9965.570313,8797910016.0,10616.612235000002,45.32255984234429,152164089564.0,0.4313407186009533,0.09486188884573302
576,578,2018-03-08,9951.44043,10147.400391,9335.870117,9395.009766,9395.009766,7186089984.0,10573.041504000004,41.48491521411908,144977999580.0,0.387537547172278,0.08499118230696749
577,579,2018-03-09,9414.69043,9466.349609,8513.030273,9337.549805,9337.549805,8704190464.0,10504.216518,41.10741365426587,136273809116.0,0.41412864771921226,0.09165094082874932
578,580,2018-03-10,9350.589844,9531.320313,8828.469727,8866.0,8866.0,5386319872.0,10436.5686385,38.047549405417115,130887489244.0,0.43967372178080916,0.06744702251571169
579,581,2018-03-11,8852.780273,9711.889648,8607.120117,9578.629883,9578.629883,6296370176.0,10430.418596642858,44.74177137421599,137183859420.0,0.40491805395602815,0.07489591482132561
580,582,2018-03-12,9602.929688,9937.5,8956.429688,9205.120117,9205.120117,6457399808.0,10347.448591071428,42.16980198444536,130726459612.0,0.4118302179255741,0.0696747622408234
581,583,2018-03-13,9173.040039,9470.379883,8958.19043,9194.849609,9194.849609,5991139840.0,10238.109305357142,42.0981397782912,124735319772.0,0.4366067950174367,0.06865983721064889
582,584,2018-03-14,9214.650391,9355.849609,8068.589844,8269.80957,8269.80957,6438230016.0,10086.102818142856,36.14094964710458,118297089756.0,0.4230901724306888,0.10925556236173546
583,585,2018-03-15,8290.759766,8428.349609,7783.049805,8300.860352,8300.860352,6834429952.0,9896.807129,36.46594847975296,125131519708.0,0.4269064020776601,0.11239719656815672
584,586,2018-03-16,8322.910156,8585.150391,8005.310059,8338.349609,8338.349609,5289379840.0,9700.517787428571,36.88360618396826,130420899548.0,0.42336880783660635,0.12772035097021397
585,587,2018-03-17,8321.910156,8346.530273,7812.819823999998,7916.879883,7916.879883,4426149888.0,9445.316336571426,34.16445892432989,125994749660.0,0.4385343252631809,0.09302363168410008
586,588,2018-03-18,7890.52002,8245.509766,7397.990234000001,8223.679688,8223.679688,6639190016.0,9210.393485071429,37.76139390241019,132633939676.0,0.43832156872534794,0.07518304975906451
587,589,2018-03-19,8344.120117,8675.870117,8182.399901999999,8630.650391,8630.650391,6729110016.0,9000.204241214284,42.26734485144632,139363049692.0,0.4321977070561389,0.08242902588755197
588,590,2018-03-20,8619.669922,9051.019531,8389.889648,8913.469727,8913.469727,6361789952.0,8866.887765214284,45.23465580017924,145724839644.0,0.4493847123323672,0.09855087985660592
589,591,2018-03-21,8937.480469,9177.370117,8846.330078,8929.280273,8929.280273,6043129856.0,8792.867048071426,45.403594067257096,151767969500.0,0.40649158996888424,0.06789454271252895
590,592,2018-03-22,8939.44043,9100.709961,8564.900391,8728.469727,8728.469727,5530390016.0,8745.257045285713,43.56541262416608,146237579484.0,0.41060755227614737,0.08713865526947095
591,593,2018-03-23,8736.25,8879.620117,8360.620117,8879.620117,8879.620117,5954120192.0,8712.547781857142,45.358606912764046,152191699676.0,0.4384863550219239,0.08382868296917974
592,594,2018-03-24,8901.950195,8996.179688,8665.700195,8668.120117,8668.120117,5664600064.0,8698.413504499998,43.28600779372345,146527099612.0,0.4111884941129438,0.11297800769607907
593,595,2018-03-25,8612.80957,8682.009766,8449.099609,8495.780273,8495.780273,4569880064.0,8621.067103785712,41.61726595578147,141957219548.0,0.4243057229654776,0.11582377179648384
594,596,2018-03-26,8498.469727,8530.080078,7921.430176000002,8209.400391,8209.400391,5921039872.0,8549.944266214285,38.93140693079718,136036179676.0,0.4045961435581045,0.09144313760458066
595,597,2018-03-27,8200.0,8232.780273,7797.279785,7833.040039,7833.040039,5378250240.0,8452.672154071426,35.67306857912547,130657929436.0,0.41230382383406416,0.10060995814567213
596,598,2018-03-28,7836.830078,8122.890137,7809.169922,7954.47998,7954.47998,4935289856.0,8430.148611928571,37.491014242987966,135593219292.0,0.3878950208304578,0.07396946459870869
597,599,2018-03-29,7979.069823999998,7994.330078,7081.379883,7165.700195,7165.700195,6361229824.0,8349.065743571427,31.302980631715805,129231989468.0,0.4484889391711316,0.08331426620881438
598,600,2018-03-30,7171.450195,7276.660156,6683.930176,6890.52002,6890.52002,6289509888.0,8245.649344357142,29.47518328417543,122942479580.0,0.3761420424505852,0.08020353904398032
599,601,2018-03-31,6892.47998,7207.850098000001,6863.52002,6973.529785,6973.529785,4553269760.0,8178.2671944999975,30.788048584131612,127495749340.0,0.4069965809048753,0.06629657989400987
600,602,2018-04-01,7003.060059,7060.950195,6526.870117,6844.22998,6844.22998,4532100096.0,8079.735072499999,29.85574056302372,122963649244.0,0.43216007614919333,0.11205042620441966
601,603,2018-04-02,6844.859863,7135.470215,6816.580078,7083.799805,7083.799805,4333440000.0,7969.24574492857,33.85251399379172,127297089244.0,0.39610121613169486,0.07382295637997306
602,604,2018-04-03,7102.259765999999,7530.939941,7072.490234000001,7456.109863,7456.109863,5499700224.0,7865.148611785713,39.61129360550064,132796789468.0,0.3902643008395448,0.051378473119753396
603,605,2018-04-04,7456.410156,7469.879883,6803.879883,6853.839844,6853.839844,4936000000.0,7716.902866857143,34.39477514175836,127860789468.0,0.4398714612935817,0.09286424075292196
604,606,2018-04-05,6848.649901999999,6933.819823999998,6644.799805,6811.470215,6811.470215,5639320064.0,7579.974330285711,34.05500069280697,122221469404.0,0.4290043953705661,0.07585026344163436
605,607,2018-04-06,6815.959961,6857.490234000001,6575.0,6636.319824,6636.319824,3766810112.0,7419.738595071428,32.620407525904,118454659292.0,0.4337701574016778,0.09065509864730015
606,608,2018-04-07,6630.509765999999,7050.540039,6630.509765999999,6911.089844,6911.089844,3976610048.0,7294.236432714285,37.09714030685177,122431269340.0,0.4158418442108273,0.06749770990966447
607,609,2018-04-08,6919.97998,7111.560059,6919.97998,7023.52002,7023.52002,3652499968.0,7189.074986071429,38.88638202426551,126083769308.0,0.3975800454792694,0.08846596514365997
608,610,2018-04-09,7044.319823999998,7178.109863,6661.990234000001,6770.72998,6770.72998,4894060032.0,7086.312813857142,36.380670469439885,121189709276.0,0.408400053590183,0.09100362203219554
609,611,2018-04-10,6795.439941,6872.410156,6704.149902,6834.759765999999,6834.759765999999,4272750080.0,7015.007080071428,37.479580644771204,125462459356.0,0.3912612912092541,0.06487900673216566
610,612,2018-04-11,6843.470215,6968.319823999998,6817.589844,6968.319823999998,6968.319823999998,4641889792.0,6944.567068928571,39.814874359115684,130104349148.0,0.3785994774404667,0.09881469216072686
611,613,2018-04-12,6955.379883,7899.22998,6806.509765999999,7889.25,7889.25,8906250240.0,6996.249197857143,52.883441587605006,139010599388.0,0.42164594020260454,0.09510916236432693
612,614,2018-04-13,7901.089844,8183.959961,7758.930176000002,7895.959961,7895.959961,7764460032.0,7068.066336499999,52.963581898447295,146775059420.0,0.3912846112662817,0.05680101963436956
613,615,2018-04-14,7874.669922,8140.709961,7846.0,7986.240234000001,7986.240234000001,5191430144.0,7140.402797142857,54.09492851267853,151966489564.0,0.40208434564960827,0.07652353474471457
614,616,2018-04-15,7999.330078,8338.419922,7999.330078,8329.110352,8329.110352,5244480000.0,7246.4656808571435,58.206360309107325,157210969564.0,0.3974121311476987,0.07311879936243194
615,617,2018-04-16,8337.570313,8371.150391,7925.72998,8058.669922,8058.669922,5631309824.0,7316.099260642856,54.09120929352329,151579659740.0,0.37645959086856506,0.08584281668937682
616,618,2018-04-17,8071.660156,8285.959961,7881.720215,7902.089844,7902.089844,6900879872.0,7347.954973571427,51.80741578411824,144678779868.0,0.4299442600426551,0.103394634764317
617,619,2018-04-18,7944.430176000002,8197.799805,7886.009765999999,8163.419922,8163.419922,6529909760.0,7441.496407714285,55.20665126486328,151208689628.0,0.41163632485350865,0.06602408928571304
618,620,2018-04-19,8159.27002,8298.69043,8138.779785,8294.30957,8294.30957,7063209984.0,7547.413504499998,56.848370263150024,158271899612.0,0.41939435427650423,0.10767038647927012
619,621,2018-04-20,8286.879883,8880.230469,8244.540039,8845.830078,8845.830078,8438110208.0,7705.235665499998,63.00167477669696,166710009820.0,0.4068451861044279,0.11164464432512249
620,622,2018-04-21,8848.790039,8997.570313,8652.150391,8895.580078,8895.580078,7548550144.0,7846.984967928571,63.507190430443394,174258559964.0,0.45194929855235255,0.08622645784516515
621,623,2018-04-22,8925.05957,9001.639648,8779.610352,8802.459961,8802.459961,6629899776.0,7974.052106571427,61.804988098164465,167628660188.0,0.4236747514457167,0.09041676421037131
622,624,2018-04-23,8794.389648,8958.549805,8788.80957,8930.879883,8930.879883,6925190144.0,8128.348528214285,63.267218045865405,174553850332.0,0.4329239994514527,0.07814033128678387
623,625,2018-04-24,8934.339844,9732.610352,8927.830078,9697.5,9697.5,10678800384.0,8332.829973499998,70.52220333986199,185232650716.0,0.3986098938455475,0.09743425850603078
624,626,2018-04-25,9701.030273,9745.320313,8799.839844,8845.740234,8845.740234,11083100160.0,8466.931431357141,57.04193446597457,174149550556.0,0.42142264217669173,0.08551674640675747
625,627,2018-04-26,8867.320313,9281.509766,8727.089844,9281.509766,9281.509766,8970559488.0,8566.378557499998,61.135060365666035,183120110044.0,0.40697665295475965,0.07728790296459137
626,628,2018-04-27,9290.629883,9375.469727,8987.049805,8987.049805,8987.049805,7566289920.0,8644.313546357142,57.171000103981825,175553820124.0,0.42034956377178084,0.09227676447681384
627,629,2018-04-28,8939.269531,9412.089844,8931.990234,9348.480469,9348.480469,7805479936.0,8741.616420285713,60.55209438971293,183359300060.0,0.41207742406196235,0.08416924118575794
628,630,2018-04-29,9346.410156,9531.490234,9193.709961,9419.080078,9419.080078,8853000192.0,8819.471400714285,61.196489665151574,192212300252.0,0.38965654338319644,0.09464393206464483
629,631,2018-04-30,9426.110352,9477.139648,9166.80957,9240.549805,9240.549805,8673920000.0,8903.891392357142,58.59005662875758,183538380252.0,0.4012880014960827,0.10557270129685259
630,632,2018-05-01,9251.469727,9255.879883,8891.049805,9119.009766,9119.009766,7713019904.0,8990.814243928571,56.81593890626365,175825360348.0,0.4064266865248229,0.10224839588852597
631,633,2018-05-02,9104.599609,9256.519531,9015.139648,9235.919922,9235.919922,7558159872.0,9067.421386785714,58.129306284315255,183383520220.0,0.43581415797176026,0.09054046632647747
632,634,2018-05-03,9233.969727,9798.330078,9188.150391,9743.860352,9743.860352,10207299584.0,9170.960728357142,63.345306085788344,193590819804.0,0.39811871413291106,0.09382032234415234
633,635,2018-05-04,9695.5,9779.200195,9585.959961,9700.759766,9700.759766,8217829888.0,9232.027134642854,62.63232011317047,185372989916.0,0.4512482940666716,0.06456463201310472
634,636,2018-05-05,9700.280273,9964.5,9695.120117,9858.150391,9858.150391,7651939840.0,9300.782156999998,64.21623886760182,193024929756.0,0.4349253595203708,0.04018027040180682
635,637,2018-05-06,9845.30957,9940.139648,9465.25,9654.799805,9654.799805,7222280192.0,9361.663574428569,60.639839090733176,185802649564.0,0.38004604251049673,0.0727417049751055
636,638,2018-05-07,9645.669922,9665.849609,9231.530273,9373.009766,9373.009766,7394019840.0,9393.24428035714,55.9866513187846,178408629724.0,0.4217015374091469,0.0945042634760506
637,639,2018-05-08,9380.870117,9462.75,9127.769531,9234.820313,9234.820313,7415869952.0,9360.195731285712,53.80614012640356,170992759772.0,0.4070904987522051,0.08963509700778219
638,640,2018-05-09,9223.730469,9374.759766,9031.620117,9325.179688,9325.179688,7226890240.0,9394.441406571426,55.03921850687789,178219650012.0,0.43281710204277984,0.08919968376761944
639,641,2018-05-10,9325.959961,9396.040039,9040.519531,9043.94043,9043.94043,6906699776.0,9377.472168285709,50.519103600750675,171312950236.0,0.4387497125157741,0.1176293123629629
640,642,2018-05-11,9052.959961,9052.959961,8394.459961,8441.490234,8441.490234,8488520192.0,9338.503627499997,42.47246379783107,162824430044.0,0.41824358911898774,0.11484389877472978
641,643,2018-05-12,8441.44043,8664.860352,8223.5,8504.889648,8504.889648,6821380096.0,9278.24714028571,43.492495871265575,169645810140.0,0.42678923525443313,0.08132147341787106
642,644,2018-05-13,8515.490234,8773.549805,8395.120117,8723.94043,8723.94043,5866379776.0,9228.594308285708,46.989863027902686,175512189916.0,0.3970538657409019,0.07640787707862776
643,645,2018-05-14,8713.099609,8881.120117,8367.969727,8716.790039,8716.790039,7364149760.0,9191.182896428569,46.887847785345144,168148040156.0,0.393478960141933,0.11520745069881945
644,646,2018-05-15,8705.19043,8836.19043,8456.450195,8510.379883,8510.379883,6705710080.0,9147.709333357141,43.923406475399,161442330076.0,0.42610587837543884,0.10110331150138588
645,647,2018-05-16,8504.410156,8508.429688,8175.490234000001,8368.830078,8368.830078,6760220160.0,9085.774344499996,41.96400950792198,154682109916.0,0.40488093206896053,0.06494818102069819
646,648,2018-05-17,8370.049805,8445.540039,8054.120117,8094.319823999998,8094.319823999998,5862530048.0,8967.950021071425,38.38756898775491,148819579868.0,0.41576771289516684,0.10794383898765918
647,649,2018-05-18,8091.830078,8274.120117,7974.819823999998,8250.969727,8250.969727,5764190208.0,8864.393589714282,41.45396176972034,154583770076.0,0.42230163650859937,0.06721919206688076
648,650,2018-05-19,8255.730469,8372.05957,8183.350098000001,8247.179688,8247.179688,4712399872.0,8749.324253785711,41.40027578724767,149871370204.0,0.4189307434323522,0.07444695613101189
649,651,2018-05-20,8246.990234,8562.410156,8205.240234,8513.25,8513.25,5191059968.0,8667.784981999996,46.62617043796456,155062430172.0,0.4136562869841116,0.11502172889126556
650,652,2018-05-21,8522.330078,8557.519531,8365.120117,8418.990234,8418.990234,5154990080.0,8599.640729714281,45.09198090790237,149907440092.0,0.44082914037215554,0.1223069191221513
651,653,2018-05-22,8419.870117,8423.25,8004.580078,8041.779785,8041.779785,5137010176.0,8514.423549142854,39.49184313389182,144770429916.0,0.3979101978744912,0.06410743063523089
652,654,2018-05-23,8037.080078,8054.660156,7507.879883,7557.819823999998,7557.819823999998,6491120128.0,8388.183558857141,33.70770127682307,138279309788.0,0.3862960743625817,0.08162372553902246
653,655,2018-05-24,7561.120117,7738.600098000001,7331.140137,7587.339844,7587.339844,6049220096.0,8284.140659857141,34.339426333090216,144328529884.0,0.4102243737778352,0.10614331677704869
654,656,2018-05-25,7592.299805,7659.140137,7392.649901999999,7480.140137,7480.140137,4867829760.0,8215.472795785709,33.10567097209396,139460700124.0,0.41450460755297447,0.04868755617430954
655,657,2018-05-26,7486.47998,7595.160156,7349.120117,7355.879883,7355.879883,4051539968.0,8133.400669714282,31.684625680558486,135409160156.0,0.3947750879068666,0.06439116235016756
656,658,2018-05-27,7362.080078,7381.740234000001,7270.959961,7368.220215,7368.220215,4056519936.0,8036.563511499996,31.99681215833043,139465680092.0,0.3791523165381908,0.08072169583739115
657,659,2018-05-28,7371.310059,7419.049805,7100.890137,7135.990234000001,7135.990234000001,5040600064.0,7923.649239714281,29.284672020467237,134425080028.0,0.37705574498742,0.0767590806399278
658,660,2018-05-29,7129.459961,7526.419922,7090.680176000002,7472.589844,7472.589844,5662660096.0,7849.5213797857095,37.54760982469037,140087740124.0,0.3982305197662776,0.09180002832054622
659,661,2018-05-30,7469.72998,7573.77002,7313.600098000001,7406.52002,7406.52002,4922540032.0,7780.7849470714245,36.64254277884224,135165200092.0,0.4184740727437422,0.10944944146643239
660,662,2018-05-31,7406.149901999999,7608.899901999999,7361.129883,7494.169922,7494.169922,5127130112.0,7737.917096928567,38.75177750870183,140292330204.0,0.4430931553274788,0.10931124934579219
661,663,2018-06-01,7500.700195,7604.72998,7407.339844,7541.450195,7541.450195,4921460224.0,7687.237130357137,39.913801584550654,145213790428.0,0.4475720065754395,0.09029828122978431
662,664,2018-06-02,7536.720215,7695.830078,7497.259765999999,7643.450195,7643.450195,4939299840.0,7644.113595142851,42.450495712444784,150153090268.0,0.437445348911884,0.10689076170710325
663,665,2018-06-03,7632.089844,7754.890137,7613.040039,7720.25,7720.25,4851760128.0,7587.470737999994,44.35534855910185,155004850396.0,0.35491200902798903,0.05976005837002114
664,666,2018-06-04,7722.529785,7753.819823999998,7474.040039,7514.470215,7514.470215,4993169920.0,7522.86216521428,40.488324091352965,150011680476.0,0.39650349616606534,0.07595195765851441
665,667,2018-06-05,7500.899901999999,7643.22998,7397.0,7633.759765999999,7633.759765999999,4961739776.0,7493.717878142852,43.56018054552922,154973420252.0,0.4064459843859034,0.09238588378706064
666,668,2018-06-06,7625.970215,7680.430176000002,7502.009765999999,7653.97998,7653.97998,4692259840.0,7500.5864607142785,44.087021336533205,159665680092.0,0.4306679129876004,0.10478351793721143
667,669,2018-06-07,7650.819823999998,7741.27002,7650.819823999998,7678.240234000001,7678.240234000001,4485799936.0,7507.079345714278,44.753358352646096,164151480028.0,0.4116658070958675,0.08157908910907223
668,670,2018-06-08,7685.140137,7698.189941,7558.399901999999,7624.919922,7624.919922,4227579904.0,7517.420758928564,43.525613192970035,159923900124.0,0.43028813428564855,0.08503036973277213
669,671,2018-06-09,7632.52002,7683.580078,7531.97998,7531.97998,7531.97998,3845220096.0,7529.999337285708,41.3939720206691,156078680028.0,0.41668323588963574,0.09697508831482547
670,672,2018-06-10,7499.549805,7499.549805,6709.069824,6786.02002,6786.02002,5804839936.0,7488.413609071424,29.082723877262396,150273840092.0,0.3849534377274448,0.06672816376819773
671,673,2018-06-11,6799.290039,6910.180176000002,6706.629883,6906.919922,6906.919922,4745269760.0,7472.051443928565,32.582442378383554,155019109852.0,0.4215353067794822,0.08215594519914803
672,674,2018-06-12,6905.819823999998,6907.959961,6542.080078,6582.3598630000015,6582.3598630000015,4654380032.0,7408.463588142851,28.514288148993515,150364729820.0,0.4312534553517074,0.08113736527799241
673,675,2018-06-13,6596.879883,6631.660156,6285.629883,6349.899902,6349.899902,5052349952.0,7332.990722571424,26.009433989145503,145312379868.0,0.40648748718533123,0.09112227025635737
674,676,2018-06-14,6342.75,6707.1401369999985,6334.459961,6675.350098,6675.350098,5138710016.0,7274.50359228571,34.663088854396875,150451089884.0,0.3880107332072796,0.08875830077416362
675,677,2018-06-15,6674.080078,6681.080078,6433.870117,6456.580078,6456.580078,3955389952.0,7197.012869642852,31.957372665138536,146495699932.0,0.4027929315892614,0.07154232473400594
676,678,2018-06-16,6455.450195,6592.490234000001,6402.290039,6550.160156,6550.160156,3194170112.0,7118.920723999995,34.31912413870191,149689870044.0,0.4324760766239178,0.051687473687057776
677,679,2018-06-17,6545.529785,6589.1098630000015,6499.27002,6499.27002,6499.27002,3104019968.0,7031.707868285709,33.63539429675713,146585850076.0,0.4040466018806687,0.061711264558698374
678,680,2018-06-18,6510.069824,6781.140137,6446.680176,6734.819823999998,6734.819823999998,4039200000.0,6976.018554642853,39.63053632776783,150625050076.0,0.4108646471139455,0.11556809635567057
679,681,2018-06-19,6742.390137,6822.5,6709.919922,6769.939941,6769.939941,4057029888.0,6914.317138571425,40.49368166631072,154682079964.0,0.4721782702364678,0.10767595493137858
680,682,2018-06-20,6770.759765999999,6821.560059,6611.879883,6776.549805,6776.549805,3888640000.0,6851.643554642853,40.66562851127875,158570719964.0,0.36122510179116873,0.07015963710440536
681,683,2018-06-21,6780.089844,6810.939941,6715.169922,6729.740234000001,6729.740234000001,3529129984.0,6783.893554642853,39.78879184345161,155041589980.0,0.4034231574373786,0.09141498113669616
682,684,2018-06-22,6737.879883,6747.080078,6006.600098,6083.689941,6083.689941,5079810048.0,6673.805698857139,30.13195532760416,149961779932.0,0.44393323324486583,0.07809666598118496
683,685,2018-06-23,6090.100098,6224.819824,6071.810059,6162.47998,6162.47998,3431360000.0,6575.98427028571,32.29027056226677,153393139932.0,0.4196062231068472,0.08034850481638159
684,686,2018-06-24,6164.279785,6223.779785,5826.410156,6173.22998,6173.22998,4566909952.0,6532.213553142853,32.59621488916859,157960049884.0,0.41627913880989503,0.09123201656805663
685,687,2018-06-25,6171.970215,6327.370117,6119.680176,6249.180176,6249.180176,5500810240.0,6485.232142714282,34.83648780361648,163460860124.0,0.42681170504846055,0.06575389228451135
686,688,2018-06-26,6253.549805,6290.160156,6093.669922,6093.669922,6093.669922,3279759872.0,6450.325718357139,32.4577331886849,160181100252.0,0.4239292259587638,0.09032438430887185
687,689,2018-06-27,6084.399902,6180.0,6052.850098,6157.129883,6157.129883,3296219904.0,6436.5564312857105,34.42550919634229,163477320156.0,0.397126605505464,0.0765483941543605
688,690,2018-06-28,6153.160156,6170.410156,5873.049805,5903.439941,5903.439941,3467800064.0,6381.419991499996,30.58886501477335,160009520092.0,0.42088582626157284,0.09489381658231698
689,691,2018-06-29,5898.129883,6261.660156,5835.75,6218.299805,6218.299805,3966230016.0,6364.399971999997,39.58786178618803,163975750108.0,0.386761691890846,0.0779674634061078
690,692,2018-06-30,6214.220215,6465.509765999999,6214.220215,6404.0,6404.0,4543860224.0,6353.959960857139,44.18410090374389,168519610332.0,0.39391641575963326,0.10073075315182584
691,693,2018-07-01,6411.680176,6432.850098,6289.290039,6385.819824,6385.819824,4788259840.0,6345.85637542857,43.832503957167596,163731350492.0,0.4198511425836843,0.07520005155615278
692,694,2018-07-02,6380.379883,6683.8598630000015,6305.700195,6614.180176,6614.180176,4396930048.0,6337.239257714282,49.29098210620398,168128280540.0,0.4264839369354024,0.06521711309497939
693,695,2018-07-03,6596.660156,6671.370117,6447.75,6529.589844,6529.589844,4672309760.0,6320.071393642853,47.45139561384921,163455970780.0,0.40800771493223187,0.09819045471883635
694,696,2018-07-04,6550.870117,6771.919922,6450.459961,6597.549805,6597.549805,4176689920.0,6307.285679357139,49.095120861932585,167632660700.0,0.41428645773654815,0.04594032583565711
695,697,2018-07-05,6599.709961,6749.540039,6546.649902,6639.1401369999985,6639.1401369999985,4999240192.0,6300.814243857138,50.12334851232303,172631900892.0,0.4102414344187741,0.06533748494066911
696,698,2018-07-06,6638.689941,6700.939941,6533.549805,6673.5,6673.5,4313959936.0,6342.943533785709,51.00386085246029,176945860828.0,0.37362269893688593,0.08265299194865144
697,699,2018-07-07,6668.709961,6863.990234000001,6579.240234000001,6856.930176000002,6856.930176000002,3961080064.0,6392.5471192142795,55.51848661131428,180906940892.0,0.43491146454133517,0.09450428712850623
698,700,2018-07-08,6857.799805,6885.910156,6747.97998,6773.879883,6773.879883,3386210048.0,6435.450683714281,53.13141026721136,177520730844.0,0.3557298896154166,0.06041438517139057
699,701,2018-07-09,6775.080078,6838.680176000002,6724.339844,6741.75,6741.75,3718129920.0,6470.634242571425,52.19638832665584,173802600924.0,0.3885249375906446,0.051610334933068776
700,702,2018-07-10,6739.209961,6767.740234000001,6320.720215,6329.950195,6329.950195,4052430080.0,6487.511404928567,41.9955586333257,169750170844.0,0.4182122841055603,0.08700975033376955
701,703,2018-07-11,6330.77002,6444.959961,6330.470215,6394.709961,6394.709961,3644859904.0,6504.481410499995,43.853870847157275,173395030748.0,0.43066598398481454,0.12610954388866752
702,704,2018-07-12,6396.779785,6397.100098,6136.419922,6228.810059,6228.810059,3770170112.0,6527.72213321428,40.29257541788446,169624860636.0,0.4466861360707612,0.04880748731115225
703,705,2018-07-13,6235.029785,6310.549805,6192.240234000001,6238.049805,6238.049805,3805400064.0,6529.1328474999955,40.58198757873293,173430260700.0,0.42145386964422826,0.1145054329247508
704,706,2018-07-14,6247.5,6298.189941,6212.220215,6276.120117,6276.120117,2923670016.0,6519.998570142851,41.83304107945704,176353930716.0,0.44789635399901506,0.10271355301863005
705,707,2018-07-15,6272.700195,6403.459961,6256.509765999999,6359.6401369999985,6359.6401369999985,3285459968.0,6518.128592499993,44.5894222694952,179639390684.0,0.39813252184233255,0.08231465234251296
706,708,2018-07-16,6357.009765999999,6741.75,6357.009765999999,6741.75,6741.75,4725799936.0,6527.240722785708,55.07776001514238,184365190620.0,0.3833074337233269,0.09017852001353412
707,709,2018-07-17,6739.649901999999,7387.240234000001,6684.169922,7321.040039,7321.040039,5961950208.0,6583.772879571422,65.6829122542104,190327140828.0,0.44782230733956785,0.08953104218105395
708,710,2018-07-18,7315.319823999998,7534.990234000001,7280.470215,7370.779785,7370.779785,6103410176.0,6639.003592428565,66.41603989653419,196430551004.0,0.4138396192845151,0.07744835415845695
709,711,2018-07-19,7378.200195,7494.459961,7295.459961,7466.859863,7466.859863,5111629824.0,6698.126429999995,67.84503795274836,201542180828.0,0.3998327735241192,0.13050997781331297
710,712,2018-07-20,7467.399901999999,7594.669922,7323.259765999999,7354.129883,7354.129883,4936869888.0,6746.74285021428,64.38353038029017,196605310940.0,0.40891277093655454,0.07155622409133028
711,713,2018-07-21,7352.720215,7437.640137,7262.410156,7419.290039,7419.290039,3726609920.0,6786.911411857138,65.47987459648928,200331920860.0,0.4018652875869304,0.07604122618706502
712,714,2018-07-22,7417.799805,7537.950195,7383.819823999998,7418.490234000001,7418.490234000001,3695460096.0,6832.955008357138,65.45324197565819,196636460764.0,0.4069912272617587,0.08080161070865217
713,715,2018-07-23,7414.709961,7771.5,7409.100098000001,7711.109863,7711.109863,5132480000.0,6902.194998571425,70.2248432648947,201768940764.0,0.41479576413058333,0.0882487063588943
714,716,2018-07-24,7716.509765999999,8424.269531,7705.5,8424.269531,8424.269531,7277689856.0,7051.789236857137,78.14689941179083,209046630620.0,0.43763678292522007,0.07082926760823649
715,717,2018-07-25,8379.660156,8416.870117,8086.359863,8181.390137,8181.390137,5845400064.0,7179.409249428566,71.19910477958817,203201230556.0,0.4047525783984684,0.07611657786599263
716,718,2018-07-26,8176.850098000001,8290.330078,7878.709961,7951.580078,7951.580078,4899089920.0,7302.464250785709,65.28471702091844,198302140636.0,0.4007655458599286,0.08943915602294512
717,719,2018-07-27,7950.399901999999,8262.660156,7839.759765999999,8165.009765999999,8165.009765999999,5195879936.0,7440.104247999995,67.94768045836065,203498020572.0,0.40382960324552886,0.05428095634568246
718,720,2018-07-28,8169.060059,8222.849609,8110.77002,8192.150391,8192.150391,3988750080.0,7576.963553285709,68.28088829625696,207486770652.0,0.42103511981719893,0.1257793803572964
719,721,2018-07-29,8205.820313,8272.259766,8141.180176000002,8218.459961,8218.459961,4107190016.0,7709.7363978571375,68.62142781030596,211593960668.0,0.378746968182862,0.08904437519277883
720,722,2018-07-30,8221.580078,8235.5,7917.5,8180.47998,8180.47998,5551400000.0,7812.502824999996,67.49489690591247,206042560668.0,0.40715742855378945,0.08975424626783321
721,723,2018-07-31,8181.200195,8181.529785,7696.930176000002,7780.439941,7780.439941,5287530000.0,7845.317103714282,56.899335848551644,200755030668.0,0.4370244927523021,0.10692714230890382
722,724,2018-08-01,7769.040039,7769.040039,7504.950195,7624.910156,7624.910156,4797620000.0,7863.469273071424,53.39013039392135,195957410668.0,0.3762789933045805,0.09057863063985318
723,725,2018-08-02,7634.189941,7712.77002,7523.439941,7567.149901999999,7567.149901999999,4214110000.0,7870.632847285709,52.10490177923814,191743300668.0,0.36322842452743426,0.0865584426035344
724,726,2018-08-03,7562.140137,7562.140137,7328.649901999999,7434.390137,7434.390137,4627150000.0,7876.365722571424,49.1747913097072,187116150668.0,0.4155910209984891,0.08156397663344316
725,727,2018-08-04,7438.669922,7497.490234000001,6984.069823999998,7032.850098000001,7032.850098000001,4268390000.0,7848.762869642852,41.56192605160927,182847760668.0,0.4335190157696511,0.12091968186871084
726,728,2018-08-05,7031.080078,7102.77002,6940.700195,7068.47998,7068.47998,3679110000.0,7823.762137214281,42.413836556948254,186526870668.0,0.3866811795509849,0.04939204323720882
727,729,2018-08-06,7062.939941,7166.549805,6890.540039,6951.799805,6951.799805,3925900000.0,7769.525704499995,40.339878191217885,182600970668.0,0.3950510313490081,0.10595008312146405
728,730,2018-08-07,6958.319823999998,7146.560059,6748.240234000001,6753.120117,6753.120117,4682800000.0,7650.157889214281,37.02036602620528,177918170668.0,0.4450807534927943,0.08682070006237702
729,731,2018-08-08,6746.850098000001,6746.850098000001,6226.220215,6305.799805,6305.799805,5064430000.0,7516.1871512142825,30.86261368594096,172853740668.0,0.3905862309353016,0.08242037304421776
730,732,2018-08-09,6305.560059,6625.72998,6249.069824,6568.22998,6568.22998,4267040000.0,7417.3764299285685,37.437324522356356,177120780668.0,0.46453090945284,0.13517893082621296
731,733,2018-08-10,6571.419922,6591.259765999999,6124.52002,6184.709961,6184.709961,4528680000.0,7275.926443857139,32.563657742645546,172592100668.0,0.43435537966613486,0.11132856492766807
732,734,2018-08-11,6185.790039,6455.740234000001,6109.029785,6295.72998,6295.72998,4047850000.0,7140.467843071425,35.19372020214197,176639950668.0,0.4215734583069316,0.09790227527065785
733,735,2018-08-12,6283.649902,6409.850098,6237.5,6322.689941,6322.689941,5665250000.0,7005.055698785711,35.84803190247605,182305200668.0,0.42539010929379856,0.12200512349521048
734,736,2018-08-13,6341.3598630000015,6537.049805,6225.720215,6297.569824,6297.569824,4083980000.0,6870.5621162142825,35.48849599488,178221220668.0,0.4041155396020056,0.08683268808956181
735,737,2018-08-14,6287.660156,6287.939941,5971.049805,6199.709961,6199.709961,5301700000.0,6757.652831928567,34.055541584215305,172919520668.0,0.4197809248911313,0.12141893293011502
736,738,2018-08-15,6221.419922,6588.490234000001,6221.419922,6308.52002,6308.52002,4895450000.0,6663.624965071424,37.096888980380285,177814970668.0,0.3966029443824983,0.08340510323708616
737,739,2018-08-16,6294.22998,6473.5,6276.410156,6334.72998,6334.72998,4328420000.0,6575.594970642853,37.840553156181976,182143390668.0,0.375703305527836,0.08301248543947146
738,740,2018-08-17,6340.910156,6582.5,6324.970215,6580.629883,6580.629883,4992990000.0,6514.612095357139,44.47316167210657,187136380668.0,0.41087438589767183,0.074711482158738
739,741,2018-08-18,6583.430176,6617.350098,6353.72998,6423.759765999999,6423.759765999999,3984520000.0,6471.105643071424,41.43565019469254,183151860668.0,0.4147698787465311,0.0884952912792621
740,742,2018-08-19,6422.569824,6537.97998,6361.549805,6506.069824,6506.069824,3311170000.0,6430.933489071424,43.6118807441099,186463030668.0,0.38366637326573805,0.0771113544013454
741,743,2018-08-20,6500.509765999999,6536.919922,6297.930176,6308.529785,6308.529785,3665100000.0,6384.985630499998,39.79035892117345,182797930668.0,0.4135996120342016,0.08313566369585282
742,744,2018-08-21,6301.069824,6500.870117,6298.240234000001,6488.759765999999,6488.759765999999,3377180000.0,6366.102748285712,44.563294031073724,186175110668.0,0.3752277418539396,0.08599458264227851
743,745,2018-08-22,6486.25,6816.790039,6310.1098630000015,6376.709961,6376.709961,4668110000.0,6371.167759428569,42.317311806987355,181507000668.0,0.4443908244998664,0.10958541046123638
744,746,2018-08-23,6371.339844,6546.540039,6371.339844,6534.879883,6534.879883,3426180000.0,6368.785609642854,46.42228825083763,184933180668.0,0.4010965442958652,0.12098369732138813
745,747,2018-08-24,6551.52002,6719.959961,6498.6401369999985,6719.959961,6719.959961,4097820000.0,6407.017752499997,50.83160843075655,189031000668.0,0.40513464745846584,0.08823316435167824
746,748,2018-08-25,6719.950195,6789.629883,6700.959961,6763.189941,6763.189941,3312600000.0,6440.407749714283,51.82881436538454,192343600668.0,0.4135220073049332,0.08941463385441997
747,749,2018-08-26,6754.640137,6774.75,6620.75,6707.259765999999,6707.259765999999,3295500000.0,6467.877022928568,50.40447404924252,189048100668.0,0.418234808957152,0.08053195306262051
748,750,2018-08-27,6710.799805,6884.640137,6689.709961,6884.640137,6884.640137,4019000000.0,6509.810616714282,54.6601328464143,193067100668.0,0.4096932571637201,0.09334150596172225
749,751,2018-08-28,6891.080078,7109.560059,6882.339844,7096.279785,7096.279785,4659940000.0,6573.851318428568,59.16267457325591,197727040668.0,0.41456965236939647,0.0790663165574184
750,752,2018-08-29,7091.709961,7113.299805,6970.819823999998,7047.160156,7047.160156,4145880000.0,6626.611328142854,57.72976101053307,193581160668.0,0.41087941933593425,0.11192341275676579
751,753,2018-08-30,7043.759765999999,7072.689941,6834.689941,6978.22998,6978.22998,4463250000.0,6672.57561385714,55.691317506087465,189117910668.0,0.42214578855188617,0.10298446053772232
752,754,2018-08-31,6973.970215,7057.169922,6920.160156,7037.580078,7037.580078,4495650000.0,6705.214913499997,57.09604782500775,193613560668.0,0.4072921186540278,0.09535140220226775
753,755,2018-09-01,7044.810059,7242.290039,7038.049805,7193.25,7193.25,4116050000.0,6760.178501642854,60.622367436654166,197729610668.0,0.4105439367684569,0.05532271673182135
754,756,2018-09-02,7189.580078,7306.310059,7132.160156,7272.720215,7272.720215,4329540000.0,6814.939243857138,62.32477894073222,202059150668.0,0.4090652562864531,0.06974240435198803
755,757,2018-09-03,7279.029785,7317.939941,7208.149901999999,7260.060059,7260.060059,4087760000.0,6882.905691999995,61.86591310615482,197971390668.0,0.3760165830035578,0.09775696929715709
756,758,2018-09-04,7263.0,7388.259765999999,7255.439941,7361.660156,7361.660156,4273640000.0,6945.255719857138,64.14723900564073,202245030668.0,0.42509712243564585,0.11206655330221871
757,759,2018-09-05,7361.459961,7388.430176000002,6792.830078,6792.830078,6792.830078,5800460000.0,6974.9785853571375,47.142795476462794,196444570668.0,0.42643854180904744,0.11062694968839054
758,760,2018-09-06,6755.140137,6755.140137,6404.720215,6529.169922,6529.169922,5523470000.0,6974.570730999994,41.63374704270548,190921100668.0,0.395949509726948,0.05266040057570263
759,761,2018-09-07,6528.919922,6555.290039,6396.870117,6467.069824,6467.069824,4264680000.0,6956.507149785709,40.43520473372527,186656420668.0,0.4088707736948322,0.08849263934715235
760,762,2018-09-08,6460.169922,6534.25,6197.52002,6225.97998,6225.97998,3835060000.0,6918.1350097142795,36.09128734651182,182821360668.0,0.384964623787333,0.0530046269278457
761,763,2018-09-09,6223.379883,6446.259765999999,6201.220215,6300.8598630000015,6300.8598630000015,3671890000.0,6889.106445214281,38.30806053049498,186493250668.0,0.35941073037033167,0.08077041496803472
762,764,2018-09-10,6301.569824,6374.97998,6292.759765999999,6329.700195,6329.700195,3714100000.0,6849.467877928567,39.183055524504574,190207350668.0,0.4215693077514491,0.10704006126401373
763,765,2018-09-11,6331.879883,6398.919922,6260.209961,6321.200195,6321.200195,3849910000.0,6794.105050071425,39.00745407197967,186357440668.0,0.4213981785676351,0.11999843837860895
764,766,2018-09-12,6317.009765999999,6363.870117,6265.089844,6351.799805,6351.799805,4064230000.0,6744.436453571425,40.04906944726825,190421670668.0,0.3671725920032846,0.07311954606051915
765,767,2018-09-13,6354.240234000001,6535.410156,6354.240234000001,6517.310059,6517.310059,4210910000.0,6711.5136020714235,45.47324764611084,194632580668.0,0.37735981239225247,0.0794692332715014
766,768,2018-09-14,6515.410156,6596.100098,6456.169922,6512.709961,6512.709961,4076220000.0,6674.022879428566,45.350434083186855,190556360668.0,0.3579687863502256,0.0717190639054104
767,769,2018-09-15,6509.399902,6561.720215,6493.549805,6543.200195,6543.200195,3216300000.0,6627.590750499994,46.384058248400066,193772660668.0,0.40457103730444316,0.09231703230642949
768,770,2018-09-16,6536.680176,6544.330078,6460.100098,6517.180176,6517.180176,3273730000.0,6573.623604857137,45.59157145312636,190498930668.0,0.38604364306488625,0.08340263929106885
769,771,2018-09-17,6514.060059,6540.209961,6257.52002,6281.200195,6281.200195,3910780000.0,6503.7050431428515,39.071715419396426,186588150668.0,0.3975061609710984,0.10270695028707143
770,772,2018-09-18,6280.910156,6384.180176,6265.709961,6371.299805,6371.299805,4180090000.0,6432.965018071423,42.45540426997097,190768240668.0,0.36058138829662595,0.0766525827940039
771,773,2018-09-19,6371.850098,6448.459961,6208.339844,6398.540039,6398.540039,4431340000.0,6404.801443857137,43.47743958481146,195199580668.0,0.4094988424817024,0.08481779152480393
772,774,2018-09-20,6398.850098,6529.259765999999,6395.950195,6519.669922,6519.669922,4348110000.0,6404.122872428567,47.90798942405464,199547690668.0,0.3976916162021109,0.08569673165285246
773,775,2018-09-21,6513.870117,6794.330078,6496.3598630000015,6734.950195,6734.950195,6531940000.0,6423.257184642852,54.703717344913244,206079630668.0,0.38872679187545967,0.06813447792281659
774,776,2018-09-22,6735.049805,6814.560059,6616.799805,6721.97998,6721.97998,4509660000.0,6458.685756071423,54.244573481155214,201569970668.0,0.43309053339669074,0.10640140790689387
775,777,2018-09-23,6715.319823999998,6766.149901999999,6679.419922,6710.629883,6710.629883,4197500000.0,6487.95504321428,53.818873501371534,197372470668.0,0.4029032995230789,0.06535656726315892
776,778,2018-09-24,6704.77002,6713.560059,6580.899902,6595.410156,6595.410156,4177310000.0,6506.934326142851,49.566354511072255,193195160668.0,0.4231698023697868,0.10899055155424797
777,779,2018-09-25,6603.6401369999985,6603.6401369999985,6381.8598630000015,6446.470215,6446.470215,4726180000.0,6515.88218471428,44.6544957832763,188468980668.0,0.38207780605307595,0.058292925643700616
778,780,2018-09-26,6452.790039,6585.910156,6397.8901369999985,6495.0,6495.0,4437300000.0,6526.110770071422,46.51434642498454,192906280668.0,0.35189855586048063,0.05415580447504335
779,781,2018-09-27,6495.290039,6712.100098000001,6464.950195,6676.75,6676.75,4606810000.0,6537.499337285708,52.8982135023565,197513090668.0,0.43204633341888526,0.138254301358204
780,782,2018-09-28,6678.75,6785.029785,6598.319824,6644.129883,6644.129883,5014430000.0,6546.886474571424,51.705384798160836,192498660668.0,0.4174995651293378,0.09177294433085877
781,783,2018-09-29,6643.100098,6643.100098,6511.649902,6601.959961,6601.959961,4363690000.0,6551.08360071428,50.13158150925012,188134970668.0,0.38714556648260096,0.072810488530925
782,784,2018-09-30,6604.709961,6643.779785,6566.540039,6625.560059,6625.560059,4002280000.0,6558.825020928566,51.02992237946437,192137250668.0,0.4248949738871972,0.08981253997222159
783,785,2018-10-01,6619.850098,6653.299805,6549.080078,6589.620117,6589.620117,4000970000.0,6580.855015357138,49.565575503319714,188136280668.0,0.4330135811783056,0.08222866923155116
784,786,2018-10-02,6593.240234000001,6611.839844,6537.899902,6556.100098,6556.100098,3979260000.0,6594.055036285708,48.1769972701209,184157020668.0,0.47879157180267173,0.06463286865099789
785,787,2018-10-03,6553.8598630000015,6571.459961,6454.029785,6502.589844,6502.589844,3887310000.0,6601.48716521428,45.96329702304924,180269710668.0,0.44741937318996355,0.13158205036184428
786,788,2018-10-04,6497.910156,6603.310059,6497.910156,6576.689941,6576.689941,3838410000.0,6605.56002371428,49.428669430843954,184108120668.0,0.35260794063826867,0.08005881977534865
787,789,2018-10-05,6574.149902,6623.620117,6557.410156,6622.47998,6622.47998,3671500000.0,6597.526436928566,51.49858394148222,187779620668.0,0.39099727394906625,0.05866927422506343
788,790,2018-10-06,6622.450195,6628.540039,6577.799805,6588.310059,6588.310059,3259740000.0,6587.978585428566,49.85857748855797,184519880668.0,0.37503291793050986,0.07282173222261294
789,791,2018-10-07,6590.680176,6641.490234000001,6557.040039,6602.950195,6602.950195,3306630000.0,6580.2871791428515,50.58467960857376,187826510668.0,0.3931441394291053,0.09014427345131015
790,792,2018-10-08,6600.189941,6675.060059,6576.040039,6652.22998,6652.22998,3979460000.0,6584.345737999994,53.04930789915102,191805970668.0,0.3977507324676379,0.09157298550282023
791,793,2018-10-09,6653.080078,6661.410156,6606.939941,6642.6401369999985,6642.6401369999985,3580810000.0,6598.357875285708,52.50054967705284,188225160668.0,0.42253106078072133,0.09394673820564937
792,794,2018-10-10,6640.290039,6640.290039,6538.959961,6585.529785,6585.529785,3787650000.0,6604.824288499994,49.23424548734742,184437510668.0,0.44522053884925533,0.07192552990555705
793,795,2018-10-11,6586.740234000001,6586.740234000001,6243.740234000001,6256.240234000001,6256.240234000001,5181640000.0,6574.787876642851,35.514494903539905,179255870668.0,0.4212322885290123,0.059565336445430606
794,796,2018-10-12,6239.25,6328.5,6236.470215,6274.580078,6274.580078,3783500000.0,6548.391461999994,36.5745894185179,183039370668.0,0.4032933364331159,0.07184779522490443
795,797,2018-10-13,6278.080078,6308.509765999999,6259.810059,6285.990234000001,6285.990234000001,3064030000.0,6525.8221957857095,37.265575073024756,186103400668.0,0.3695218047121848,0.05672664473902952
796,798,2018-10-14,6288.490234000001,6363.209961,6280.149902,6290.930176,6290.930176,3085320000.0,6501.920061285709,37.58262393783119,189188720668.0,0.4181940050140872,0.08769887819680987
797,799,2018-10-15,6292.6401369999985,6965.060059,6258.680176,6596.540039,6596.540039,7370770000.0,6502.4143414285645,53.305072603621255,196559490668.0,0.44528706737275425,0.07417981667657887
798,800,2018-10-16,6601.410156,6673.589844,6571.370117,6596.1098630000015,6596.1098630000015,4074800000.0,6505.272181785709,53.2847265158786,192484690668.0,0.4094102034539429,0.11190207321702535
799,801,2018-10-17,6590.52002,6601.209961,6517.450195,6544.430176,6544.430176,4088420000.0,6508.260776928566,50.777233178836546,188396270668.0,0.3467995035724135,0.023104136957991548
800,802,2018-10-18,6542.330078,6567.540039,6450.040039,6476.709961,6476.709961,3924080000.0,6501.119349785708,47.61520427563122,184472190668.0,0.42823951872607335,0.07404289842189002
801,803,2018-10-19,6478.069824,6493.680176,6445.310059,6465.410156,6465.410156,3578870000.0,6489.900076642852,47.08828152772233,180893320668.0,0.41736450792975344,0.10071784948115062
802,804,2018-10-20,6460.919922,6497.720215,6449.0,6489.189941,6489.189941,3379130000.0,6482.82006821428,48.38282659103295,184272450668.0,0.3778322097454596,0.08467282809111432
803,805,2018-10-21,6490.089844,6556.379883,6476.0,6482.350098,6482.350098,3253610000.0,6474.205775571422,48.018911130310784,181018840668.0,0.37730792324679024,0.013673112528991364
804,806,2018-10-22,6486.049805,6543.799805,6462.97998,6487.160156,6487.160156,3672860000.0,6462.415073857136,48.31333744543165,184691700668.0,0.398514865749845,0.07491857380720242
805,807,2018-10-23,6472.3598630000015,6506.009765999999,6451.27002,6475.740234000001,6475.740234000001,3716150000.0,6450.49365221428,47.62365138358262,180975550668.0,0.4100013001023942,0.077878264139577
806,808,2018-10-24,6478.8901369999985,6521.990234000001,6468.8598630000015,6495.839844,6495.839844,3424670000.0,6444.087227857136,49.00350777899843,184400220668.0,0.41645118584599955,0.061766854375536716
807,809,2018-10-25,6484.649902,6504.649902,6447.029785,6476.290039,6476.290039,3230550000.0,6459.805071071422,47.687546432823666,181169670668.0,0.43662987462478164,0.061377414794247805
808,810,2018-10-26,6468.439941,6498.290039,6449.6098630000015,6474.75,6474.75,3306050000.0,6474.102922642852,47.57915208549333,177863620668.0,0.42346014991809927,0.06251330624764852
809,811,2018-10-27,6480.839844,6507.410156,6453.529785,6480.379883,6480.379883,3393250000.0,6487.987897571424,48.04408361551752,181256870668.0,0.4214818608550672,0.0664768987227616
810,812,2018-10-28,6482.660156,6502.279785,6447.910156,6486.3901369999985,6486.3901369999985,3445190000.0,6501.9493233571375,48.56851916958644,184702060668.0,0.39057674732085745,0.09179102633122004
811,813,2018-10-29,6492.350098,6503.600098,6306.990234000001,6332.629883,6332.629883,4199910000.0,6483.098597928566,38.00071359033404,180502150668.0,0.3646425305109637,0.04589933766310494
812,814,2018-10-30,6337.040039,6364.990234000001,6310.1401369999985,6334.27002,6334.27002,3781100000.0,6464.395751999994,38.15529355602344,184283250668.0,0.3917265689098806,0.09051450130470248
813,815,2018-10-31,6336.990234000001,6349.160156,6316.879883,6317.6098630000015,6317.6098630000015,4191240000.0,6448.194301071423,37.14227213162573,180092010668.0,0.39896937359510254,0.10035574927523438
814,816,2018-11-01,6318.1401369999985,6547.1401369999985,6311.830078,6377.779785,6377.779785,3789400000.0,6441.127859928566,43.02566854066473,183881410668.0,0.4369842161504443,0.12966365059886284
815,817,2018-11-02,6378.919922,6396.8598630000015,6327.379883,6388.439941,6388.439941,4234870000.0,6435.629987428567,44.025277583472004,188116280668.0,0.4194087869435092,0.1354162157287157
816,818,2018-11-03,6387.240234000001,6400.069824,6342.370117,6361.259765999999,6361.259765999999,3658640000.0,6426.49211778571,42.0018274913328,184457640668.0,0.3681548731944934,0.057743855397252776
817,819,2018-11-04,6365.470215,6388.629883,6294.569824,6376.129883,6376.129883,4390020000.0,6418.904959571424,43.53096856293693,188847660668.0,0.4317163640289163,0.08024504842591727
818,820,2018-11-05,6363.620117,6480.589844,6363.620117,6419.660156,6419.660156,4174800000.0,6414.083530999997,47.86437585304843,193022460668.0,0.4402103666779337,0.09603975931785928
819,821,2018-11-06,6433.379883,6463.549805,6408.160156,6461.009765999999,6461.009765999999,4700040000.0,6413.031354714281,51.65924909045327,197722500668.0,0.3711105758917949,0.07559082180379104
820,822,2018-11-07,6468.5,6552.160156,6468.310059,6530.1401369999985,6530.1401369999985,4941260000.0,6415.481375642853,57.260377525393906,202663760668.0,0.40397537591437366,0.08266170875420385
821,823,2018-11-08,6522.27002,6536.919922,6438.529785,6453.720215,6453.720215,4665260000.0,6413.8692453571375,50.3194092610743,197998500668.0,0.3810097589390084,0.06762111250229894
822,824,2018-11-09,6442.600098,6456.459961,6373.370117,6385.620117,6385.620117,4346820000.0,6407.502825142851,45.07574804901672,193651680668.0,0.38386641716772185,0.060738192329044344
823,825,2018-11-10,6386.129883,6437.279785,6385.310059,6409.220215,6409.220215,3705320000.0,6402.419991714281,47.13184686406585,197357000668.0,0.3707255321334646,0.08405656329538637
824,826,2018-11-11,6413.629883,6423.25,6350.169922,6411.27002,6411.27002,3939060000.0,6397.054269071424,47.3163226370053,201296060668.0,0.39353425375793794,0.08556108737089599
825,827,2018-11-12,6411.759765999999,6434.209961,6360.470215,6371.27002,6371.27002,4295770000.0,6399.814278857138,44.08369754254849,197000290668.0,0.33628483507764817,0.0679723551856268
826,828,2018-11-13,6373.189941,6395.27002,6342.669922,6359.490234000001,6359.490234000001,4503800000.0,6401.615722714279,43.14877650140873,192496490668.0,0.3893195219127784,0.06347561116238332
827,829,2018-11-14,6351.240234000001,6371.549805,5544.089844,5738.350098,5738.350098,7398940000.0,6360.240025214279,19.574842292705807,185097550668.0,0.40174777088239016,0.07126082679397477
828,830,2018-11-15,5736.149902,5774.819824,5358.379883,5648.029785,5648.029785,7032140000.0,6308.115025214279,18.032109726218025,178065410668.0,0.38476658762757676,0.08911309305352068
829,831,2018-11-16,5645.319824,5657.02002,5498.939941,5575.549805,5575.549805,5279320000.0,6250.051444071422,16.882262012317018,172786090668.0,0.39743141471975607,0.06443640409863387
830,832,2018-11-17,5578.580078,5578.580078,5519.560059,5554.330078,5554.330078,4303150000.0,6192.413609214279,16.549536554004703,168482940668.0,0.39716001319458333,0.09115097737641868
831,833,2018-11-18,5559.740234000001,5653.6098630000015,5559.740234000001,5623.540039,5623.540039,4159680000.0,6138.657191785706,21.952451812171148,172642620668.0,0.42544192857688207,0.06633707647585811
832,834,2018-11-19,5620.779785,5620.779785,4842.910156,4871.490234000001,4871.490234000001,7039560000.0,6028.073625928564,12.489741626756127,165603060668.0,0.42265148339208497,0.0676553816243232
833,835,2018-11-20,4863.930176,4951.6098630000015,4272.1098630000015,4451.870117,4451.870117,8428290000.0,5884.563650999991,9.920239202382476,157174770668.0,0.42182213736899654,0.08034903934143268
834,836,2018-11-21,4465.540039,4675.72998,4343.97998,4602.169922,4602.169922,6120120000.0,5746.851492785708,16.54308586272508,163294890668.0,0.3534357614089452,0.07035010979007081
835,837,2018-11-22,4611.569824,4629.6401369999985,4365.6401369999985,4365.939941,4365.939941,4569370000.0,5597.724330357138,14.71221834936398,158725520668.0,0.34436136868823414,0.013405344025388698
836,838,2018-11-23,4360.700195,4396.419922,4195.680176,4347.1098630000015,4347.1098630000015,4871490000.0,5452.116455071423,14.573761690957241,153854030668.0,0.40816215735442024,0.10585484871360475
837,839,2018-11-24,4347.689941,4413.089844,3795.159912,3880.76001,3880.76001,4679500000.0,5271.51215471428,11.649655311032047,149174530668.0,0.392178667653878,0.09221814178361547
838,840,2018-11-25,3880.780029,4120.870117,3585.060059000001,4009.969971,4009.969971,6825640000.0,5099.990722642852,16.640189746283866,156000170668.0,0.3644367691732507,0.029797478467612114
839,841,2018-11-26,4015.070068,4107.1401369999985,3643.919922,3779.129883,3779.129883,6476900000.0,4914.837855714281,15.009047419992001,149523270668.0,0.40190592034645417,0.09322407976348432
840,842,2018-11-27,3765.949951,3862.959961,3661.01001,3820.719971,3820.719971,5998720000.0,4733.497122642852,16.595353972338998,155521990668.0,0.4143641819225274,0.06682234248601326
841,843,2018-11-28,3822.469971,4385.899902,3822.469971,4257.419922,4257.419922,7280280000.0,4627.716395785709,31.13049832097101,162802270668.0,0.464323376325478,0.11786686148759691
842,844,2018-11-29,4269.004395,4413.020508,4145.7651369999985,4278.84668,4278.84668,6503347767.0,4529.917602571422,31.75889396729561,169305618435.0,0.38324184649825893,0.08487438548154187
843,845,2018-11-30,4289.088867,4322.976563,3942.822021,4017.268555,4017.268555,6048016717.0,4418.611798999994,28.357172203073148,163257601718.0,0.36583743106199534,0.04764623800530241
844,846,2018-12-01,4024.464355,4309.377441,3969.710693,4214.671875,4214.671875,5375314093.0,4322.921927357137,34.0942949671269,168632915811.0,0.37204679804577406,0.06470464619094868
845,847,2018-12-02,4200.7333979999985,4301.519531,4110.978515999999,4139.87793,4139.87793,5262697895.0,4216.946062428567,33.015507066467684,163370217916.0,0.3659535665416297,0.08323699886781948
846,848,2018-12-03,4147.32373,4155.979492,3840.446289,3894.130859,3894.130859,5089570994.0,4147.134678499994,29.69128560980066,158280646922.0,0.40708109056613534,0.0828195613896911
847,849,2018-12-04,3886.294922,4075.627686,3832.75,3956.893799,3956.893799,5028069239.0,4111.779227214281,31.585884613260237,163308716161.0,0.38722748502192184,0.09353021597311435
848,850,2018-12-05,3958.894775,3969.535889,3753.994873,3753.994873,3753.994873,5302481574.0,4051.195295142852,28.87682397724448,158006234587.0,0.40752115039400344,0.09295494399128945
849,851,2018-12-06,3754.074463,3874.966064,3521.101807,3521.101807,3521.101807,5878333109.0,3990.849714142852,26.10877557485153,152127901478.0,0.3894823455009179,0.08059055488572003
850,852,2018-12-07,3512.590332,3512.590332,3280.22876,3419.937256,3419.937256,6835615448.0,3924.6230993571376,24.988262824025103,145292286030.0,0.4432365124673412,0.06888025358947038
851,853,2018-12-08,3421.9104,3506.043457,3350.650635,3476.114746,3476.114746,5305024497.0,3895.719866214281,26.865298162584853,150597310527.0,0.43054079635136316,0.09519953693031626
852,854,2018-12-09,3473.227539,3685.305664,3469.094238,3614.234375,3614.234375,4947372847.0,3867.453037928567,31.40976827226445,155544683374.0,0.4178131921212508,0.0405655274937785
853,855,2018-12-10,3612.046387,3647.33252,3470.144531000001,3502.656006,3502.656006,5020968740.0,3847.7049038571377,29.798867448701888,150523714634.0,0.4118091387464835,0.06643684283389133
854,856,2018-12-11,3497.554688,3513.185059000001,3392.25,3424.588135,3424.588135,4696765188.0,3819.40977271428,28.690167161088173,145826949446.0,0.39755904176550766,0.11141230725378587
855,857,2018-12-12,3421.458252000001,3534.228516,3413.481445000001,3486.950195000001,3486.950195000001,4139364829.0,3764.3762207857094,30.901804473181098,149966314275.0,0.37553820848043473,0.10393987952090149
856,858,2018-12-13,3487.8793950000004,3489.739502000001,3298.13208,3313.677246,3313.677246,4343372456.0,3695.4355469285656,28.277575876782393,145622941819.0,0.36017179556672435,0.06087668439989378
857,859,2018-12-14,3311.751953,3329.555908,3206.542236,3242.484863,3242.484863,4372763663.0,3640.093854642851,27.25351041286105,141250178156.0,0.40364738592212723,0.08756128942207661
858,860,2018-12-15,3243.997559,3275.37793,3191.303467,3236.761719,3236.761719,3551763561.0,3570.2431292142796,27.168331061057273,137698414595.0,0.42623878328175707,0.1013666450786545
859,861,2018-12-16,3236.274658,3305.753174,3233.819824,3252.839111,3252.839111,3744248994.0,3506.883213571423,27.850529373623857,141442663589.0,0.43120028314507497,0.09617741981672251
860,862,2018-12-17,3253.123047,3597.917969,3253.123047,3545.864746,3545.864746,5409247918.0,3482.007062642851,39.05525750813914,146851911507.0,0.4399692036826588,0.12240477012736588
861,863,2018-12-18,3544.761475,3701.349365,3487.169189,3696.059082,3696.059082,5911325473.0,3463.3760114285656,43.86717015166112,152763236980.0,0.42780489251767917,0.07408340416517234
862,864,2018-12-19,3706.824951,3949.322998,3687.22998,3745.950684,3745.950684,6810689119.0,3462.801426499995,45.409085167045355,159573926099.0,0.44073369401038376,0.10181108819496543
863,865,2018-12-20,3742.195068,4191.228515999999,3728.974609,4134.441406,4134.441406,8927129279.0,3506.611397857137,55.62963743741712,168501055378.0,0.3947068980724312,0.07657179154858668
864,866,2018-12-21,4133.7036130000015,4198.429688,3850.946289,3896.543701,3896.543701,7206015706.0,3540.6547153571382,49.516073297143755,161295039672.0,0.4121088891859472,0.07914848265900538
865,867,2018-12-22,3898.08374,4014.182617,3855.739014,4014.182617,4014.182617,5605823233.0,3579.088134714281,52.30724223937035,166900862905.0,0.4171978744230481,0.102332440743107
866,868,2018-12-23,4020.994629,4085.723633,3976.405762,3998.980225,3998.980225,6151275490.0,3606.569981142852,51.90783903768728,160749587415.0,0.38336787415645635,0.08688408680873312
867,869,2018-12-24,4000.331787,4271.79248,4000.331787,4078.599121,4078.599121,7240968501.0,3647.708775071424,53.89348108199485,167990555916.0,0.4329746240657868,0.06432325947435931
868,870,2018-12-25,4081.030518,4089.561523,3760.020508,3815.490723,3815.490723,6158207293.0,3675.630388499995,46.98906834957266,161832348623.0,0.42642002427178394,0.091321830320326
869,871,2018-12-26,3819.666748,3893.359619,3769.86377,3857.297607,3857.297607,5326547918.0,3702.083775071424,48.126265584492465,167158896541.0,0.400035466434822,0.07824891761083565
870,872,2018-12-27,3854.688477,3874.416992,3645.448486,3654.833496,3654.833496,5130222366.0,3726.452078642853,43.2836582810641,162028674175.0,0.37827316114196835,0.05314170912351679
871,873,2018-12-28,3653.131836,3956.135986,3642.63208,3923.918701,3923.918701,5631554348.0,3775.1259242142814,50.423655499598226,167660228523.0,0.39471360136241534,0.0867410792488006
872,874,2018-12-29,3932.491699,3963.758789,3820.408691,3820.408691,3820.408691,4991655917.0,3816.8149936428526,47.924328489957574,162668572606.0,0.4123341364650054,0.10163587993366005
873,875,2018-12-30,3822.384766,3901.908936,3797.219238,3865.952637,3865.952637,4770578575.0,3860.6088169285667,49.11934643107285,167439151181.0,0.40734624943066927,0.08030499091637221
874,876,2018-12-31,3866.839111,3868.74292,3725.867432,3742.700439,3742.700439,4661840806.0,3874.6685092857106,46.040232522622205,162777310375.0,0.413771493313684,0.08453585401452376
875,877,2019-01-01,3746.713379,3850.913818,3707.231201,3843.52002,3843.52002,4324200990.0,3885.201433428567,48.86403632881538,167101511365.0,0.4188604627152085,0.07193238816921182
876,878,2019-01-02,3849.216309,3947.981201,3817.409424,3943.409424,3943.409424,5244856836.0,3899.305629142853,51.5683256325285,172346368201.0,0.39162402966103954,0.08013339187540781
877,879,2019-01-03,3931.048584000001,3935.685059,3826.2229,3836.741211,3836.741211,4530215219.0,3878.0413294999958,48.61188316498178,167816152982.0,0.4554534412944981,0.09245317244228167
878,880,2019-01-04,3832.040039,3865.93457,3783.85376,3857.717529,3857.717529,4847965467.0,3875.2680314999957,49.22831758207555,172664118449.0,0.3681291422505125,0.07285402026562238
879,881,2019-01-05,3851.973877,3904.903076,3836.900146,3845.19458,3845.19458,5137609824.0,3863.197457428567,48.851557720059546,167526508625.0,0.40479448760890857,0.09145347808148042
880,882,2019-01-06,3836.519043,4093.297363,3826.513184,4076.632568,4076.632568,5597027440.0,3868.7440533571394,55.61271358246751,173123536065.0,0.3864947852585965,0.10764777267192083
881,883,2019-01-07,4078.584961,4092.613525,4020.894043,4025.248291,4025.248291,5228625637.0,3864.9332797857105,53.908872548168276,167894910428.0,0.4001951272804621,0.09262433213503599
882,884,2019-01-08,4028.472168,4109.020996,3996.955322,4030.8479,4030.8479,5306593305.0,3880.3159352857106,54.07400244935915,173201503733.0,0.3850184887546645,0.07059034572191931
883,885,2019-01-09,4031.552002,4068.403564,4022.662842,4035.296387,4035.296387,5115905225.0,3893.0301338571385,54.21434105734636,178317408958.0,0.37288429274139523,0.052764473033554186
884,886,2019-01-10,4034.411377,4064.06665,3659.174561,3678.924561,3678.924561,6874143796.0,3894.7509242142814,42.90366263340763,171443265162.0,0.38141229707857693,0.08187075422415087
885,887,2019-01-11,3674.015381,3713.881836,3653.069824,3687.365479,3687.365479,5538712865.0,3877.8542654999956,43.20590037317087,176981978027.0,0.398937868896808,0.08832211926456221
886,888,2019-01-12,3686.973145,3698.978271,3653.810791,3661.301025,3661.301025,4778170883.0,3866.4894322142823,42.45850775669297,172203807144.0,0.40941079836774796,0.06097181253360914
887,889,2019-01-13,3658.868164,3674.76001,3544.927246,3552.953125,3552.953125,4681302466.0,3844.1323242142817,39.406861817280884,167522504678.0,0.37385881243401065,0.07221233453922526
888,890,2019-01-14,3557.311035,3727.836182,3552.285156000001,3706.052246,3706.052246,5651384490.0,3841.514596142853,45.38068729863095,173173889168.0,0.436467100119274,0.07737859126083764
889,891,2019-01-15,3704.216309,3720.15332,3619.949219,3630.675293,3630.675293,5537192302.0,3826.3114013571385,43.126332952589905,167636696866.0,0.4079780545075438,0.09428893735942484
890,892,2019-01-16,3631.509766,3685.7771,3624.67334,3655.006836,3655.006836,5394457145.0,3805.7112164999958,44.09181075822032,173031154011.0,0.40256836853074324,0.07907815532456879
891,893,2019-01-17,3651.871094,3680.135986,3621.960938,3678.563965,3678.563965,5464420383.0,3794.4128417857105,45.06416428071954,178495574394.0,0.41719050985150874,0.08479857060898022
892,894,2019-01-18,3677.990479,3682.52002,3637.080811,3657.839355,3657.839355,5002961727.0,3780.1358293571375,44.33364630448365,173492612667.0,0.3863563780642368,0.08404705614199467
893,895,2019-01-19,3652.37793,3758.533447,3652.37793,3728.568359,3728.568359,5955691380.0,3771.805384999995,47.46372136101391,179448304047.0,0.34528433013623866,0.07485101136645758
894,896,2019-01-20,3725.446045,3743.387939,3583.019531000001,3601.013672,3601.013672,5582489560.0,3737.832606714281,42.79072751003643,173865814487.0,0.39232416734500064,0.08145599732058063
895,897,2019-01-21,3600.372803,3608.84082,3558.537109000001,3576.032471,3576.032471,5004347059.0,3705.745762428567,41.920247430730036,168861467428.0,0.42625886729705387,0.09615906597536229
896,898,2019-01-22,3575.0812990000004,3620.746582,3539.721436,3604.577148,3604.577148,5313623556.0,3675.297851571424,43.338627944282294,174175090984.0,0.42248394781488086,0.08017786365831797
897,899,2019-01-23,3605.557129,3623.067871,3565.313965,3585.123047,3585.123047,5433755649.0,3643.142612999995,42.575498074907095,168741335335.0,0.4507189924948951,0.05985036117365783
898,900,2019-01-24,3584.500244,3616.087402,3569.092773,3600.865479,3600.865479,5262869046.0,3637.566964285709,43.4433631542029,174004204381.0,0.4122638421034701,0.08664320883720414
899,901,2019-01-25,3607.390381,3612.927734,3575.597412,3599.765869,3599.765869,5265847539.0,3631.3098492857093,43.394030270497,168738356842.0,0.4698540875852505,0.05193573049060854
900,902,2019-01-26,3599.715332,3654.933105,3593.345947,3602.460449,3602.460449,5098183235.0,3627.1069509999943,43.563157236694416,173836540077.0,0.39699999505837125,0.12019793763000286
901,903,2019-01-27,3604.687256,3612.671387,3567.24585,3583.965820000001,3583.965820000001,5570752966.0,3629.3221434999946,42.621869620087,168265787111.0,0.3715604993664482,0.0876995867744994
902,904,2019-01-28,3584.283203,3586.750977,3439.23291,3470.450439,3470.450439,6908930483.0,3612.4934429999953,37.29526495560178,161356856628.0,0.42899762833602917,0.046874208975329984
903,905,2019-01-29,3468.8701170000004,3476.06543,3400.819824,3448.116943,3448.116943,5897159493.0,3599.4535608571373,36.33319156940493,155459697135.0,0.4067739626980609,0.08846030496205169
904,906,2019-01-30,3443.896973,3495.174805,3429.387939,3486.181641,3486.181641,5955112627.0,3587.394618357138,39.21143015339013,161414809762.0,0.399181556970471,0.07871396241047943
905,907,2019-01-31,3485.40918,3504.804932,3447.915771,3457.792725,3457.792725,5831198271.0,3571.6252440714234,37.83755313253358,155583611491.0,0.39070865344346023,0.09239115181531916
906,908,2019-02-01,3460.547119,3501.954102,3431.591553,3487.945313,3487.945313,5422926707.0,3559.489955357138,40.23284387409825,161006538198.0,0.41014313165649724,0.07597089662345836
907,909,2019-02-02,3484.625977,3523.287354,3467.574707,3521.0607909999994,3521.0607909999994,5071623601.0,3544.667986214281,42.837970814422725,166078161799.0,0.4130553829211731,0.09024429029023752
908,910,2019-02-03,3516.139648,3521.388184000001,3447.924316,3464.013428,3464.013428,5043937584.0,3534.8822544999957,39.633079225945956,161034224215.0,0.4252249273691708,0.11625369975419317
909,911,2019-02-04,3467.21167,3476.223877000001,3442.586914,3459.154053,3459.154053,5332718886.0,3526.533796071424,39.36293144107976,155701505329.0,0.4470775508766882,0.07479147197165553
910,912,2019-02-05,3454.950928,3478.148193,3451.937012,3466.357422,3466.357422,5227549545.0,3516.6609584999956,40.015643342427296,160929054874.0,0.41642378135316854,0.10796229453819058
911,913,2019-02-06,3469.091797,3469.091797,3398.56543,3413.767822,3413.767822,5482196038.0,3504.421299571424,36.89330617750915,155446858836.0,0.4309136327646369,0.11219751969567135
912,914,2019-02-07,3414.929443,3427.945557,3394.218506,3399.47168,3399.47168,5004962683.0,3490.036028214281,36.06937250681101,150441896153.0,0.49089513385876204,0.16945020119644563
913,915,2019-02-08,3401.376465,3695.614014,3391.023682,3666.780273,3666.780273,7735623101.0,3494.822771357138,55.90080502745836,158177519254.0,0.39479784113405864,0.060504036346034525
914,916,2019-02-09,3671.585938,3679.941406,3646.559326,3671.203613,3671.203613,6158833645.0,3499.732997357138,56.14324470799775,164336352899.0,0.37677719343104676,0.09709832807126043
915,917,2019-02-10,3673.201416,3695.036133,3640.97998,3690.188232,3690.188232,6282256903.0,3507.320312499996,57.230040936355095,170618609802.0,0.4089988525315463,0.0771432505735474
916,918,2019-02-11,3695.613037,3695.613037,3642.287842,3648.430664,3648.430664,6277056434.0,3520.033185714281,54.05695939016578,164341553368.0,0.39224544651099036,0.0870148372212056
917,919,2019-02-12,3642.751953,3668.586914,3618.556885,3653.528564,3653.528564,6480384532.0,3534.7054443571387,54.38943776347674,170821937900.0,0.378876412535789,0.058348685994533675
918,920,2019-02-13,3653.604004,3669.746582,3617.246338,3632.070557,3632.070557,6438903823.0,3545.1260812142805,52.661917736213454,164383034077.0,0.3693198683986428,0.06835203049893948
919,921,2019-02-14,3631.170166,3646.256592,3607.697754,3616.880859,3616.880859,6271044418.0,3556.489519357138,51.416946708420745,158111989659.0,0.3702987603800516,0.0621993796687827
920,922,2019-02-15,3617.368408,3647.795166,3608.206543,3620.810791,3620.810791,6091952231.0,3565.9799106428513,51.73486584630064,164203941890.0,0.4237976800789052,0.07689660082279032
921,923,2019-02-16,3615.270264,3652.841309,3615.270264,3629.787598,3629.787598,5934744052.0,3573.746111142852,52.49949634528283,170138685942.0,0.3927426658195932,0.07024743263837231
922,924,2019-02-17,3633.359375,3680.537354,3619.182129,3673.836182,3673.836182,7039512503.0,3588.7334507142805,56.16889787419154,177178198445.0,0.3984451106642162,0.0720533179888408
923,925,2019-02-18,3671.369873,3936.665039,3669.982422,3915.714355,3915.714355,9908216640.0,3621.3449008571374,69.91319434868754,187086415085.0,0.4310335177540384,0.0841345797360363
924,926,2019-02-19,3911.661621,4010.879395,3908.153076,3947.094482,3947.094482,9933626655.0,3655.683262285709,71.176001550633,197020041740.0,0.3782437585808734,0.08981370905876888
925,927,2019-02-20,3946.685059,4000.486328,3926.246826,3999.820557,3999.820557,8693373948.0,3697.5441719285664,73.21060294605533,205713415688.0,0.4643573645975366,0.06701076471412336
926,928,2019-02-21,4000.256836,4010.009521,3940.108154,3954.118164,3954.118164,7775128102.0,3737.1617779285657,68.68491448243103,197938287586.0,0.4122564974831271,0.09661360602514084
927,929,2019-02-22,3952.406494,4006.53833,3950.816406,4005.526611,4005.526611,7826525254.0,3761.3579449285658,70.86655289887844,205764812840.0,0.4089956511661861,0.0633984179102917
928,930,2019-02-23,3998.91626,4166.286133,3968.726807,4142.526855,4142.526855,8922258316.0,3795.023890785709,75.72092298372809,214687071156.0,0.33330067977922445,0.053194055931565315
929,931,2019-02-24,4145.458008,4210.6416020000015,3793.708984,3810.42749,3810.42749,10794227451.0,3803.612409214281,52.76781469260542,203892843705.0,0.4040861186599244,0.06504610933869251
930,932,2019-02-25,3807.002441,3913.707275,3807.002441,3882.696289,3882.696289,9318796067.0,3820.345668142852,55.90056719758515,213211639772.0,0.3950249773915341,0.09335855584896603
931,933,2019-02-26,3878.697266,3891.578857,3837.986328,3854.35791,3854.35791,7931218996.0,3834.6906214285664,54.377509999849316,205280420776.0,0.4268668232481334,0.07131712971309091
932,934,2019-02-27,3857.479736,3888.80249,3787.058838,3851.047363,3851.047363,8301309684.0,3850.3318218571376,54.19175408799384,196979111092.0,0.4338052231959892,0.12591926696462452
933,935,2019-02-28,3848.261963,3906.05835,3845.821289,3854.7854,3854.7854,8399767798.0,3867.325003357138,54.38124799441314,205378878890.0,0.42389498991203806,0.1076082313768139
934,936,2019-03-01,3853.75708,3907.79541,3851.692383,3859.58374,3859.58374,7661247975.0,3884.3802139999957,54.6406364506384,213040126865.0,0.40113411521125264,0.03953628667920948
935,937,2019-03-02,3855.318115,3874.607422,3832.12793,3864.415039,3864.415039,7578786076.0,3901.139316928567,54.918583698022786,220618912941.0,0.4180873829458682,0.05549150855378064
936,938,2019-03-03,3862.266113,3875.483643,3836.905762,3847.175781,3847.175781,7253558152.0,3913.5207168571374,53.65516785169365,213365354789.0,0.3860365488324159,0.11964673113664401
937,939,2019-03-04,3845.091553,3867.381836,3733.749756,3761.557129,3761.557129,9029175788.0,3902.509486428567,47.776537373772754,204336179001.0,0.40398775629149986,0.11032650264039073
938,940,2019-03-05,3759.83252,3903.916748,3745.183105,3896.375,3896.375,10174126415.0,3898.8866662857104,55.95902395089463,214510305416.0,0.40588709754043545,0.07819023781227692
939,941,2019-03-06,3897.081055,3919.510498,3871.460693,3903.942627,3903.942627,9175291529.0,3892.038242714281,56.3722421761641,223685596945.0,0.38626918678350974,0.10604149624640305
940,942,2019-03-07,3903.384766,3939.373291,3894.113037,3911.484375,3911.484375,9584165519.0,3888.992972071424,56.807183864043274,233269762464.0,0.40560357344384695,0.09577165146717564
941,943,2019-03-08,3913.22583,3950.432129,3875.228516,3901.131592,3901.131592,10638638944.0,3881.536184999995,55.98212057314705,222631123520.0,0.38380221592070546,0.0684308771196792
942,944,2019-03-09,3894.55249,3987.237793,3892.390381,3963.313721,3963.313721,10796103518.0,3868.7352468571376,59.76228327747987,233427227038.0,0.3676346086861155,0.06568834084771492
943,945,2019-03-10,3966.174316,3966.174316,3924.381104,3951.599854,3951.599854,9713267607.0,3878.818987142852,58.73892720352471,223713959431.0,0.44597447941324747,0.05789477046174899
944,946,2019-03-11,3953.740234,3966.384766,3889.239014,3905.227295,3905.227295,10125901903.0,3880.42834471428,54.74251914660161,213588057528.0,0.38040754323120374,0.07155656985050256
945,947,2019-03-12,3903.758301,3926.88916,3863.559082,3909.15625,3909.15625,9809887079.0,3884.3425118571367,55.02173954732297,223397944607.0,0.3626842184693801,0.06317772836376458
946,948,2019-03-13,3913.047363,3926.597656,3891.904297,3906.717285,3906.717285,9469184841.0,3888.318934857137,54.795735235449236,213928759766.0,0.39760481634366934,0.08302700934204327
947,949,2019-03-14,3905.576904,3946.504395,3901.296875,3924.369141,3924.369141,10480789570.0,3893.289202071424,56.19804949292006,224409549336.0,0.37869262612717725,0.059971482829096236
948,950,2019-03-15,3926.66333,3968.542969,3914.015381,3960.911133,3960.911133,9394210605.0,3900.5268729999952,59.03142004621778,233803759941.0,0.472765071837827,0.06602820739259108
949,951,2019-03-16,3963.900146,4077.036377,3961.657471,4048.72583,4048.72583,9856166973.0,3913.6919294999952,64.9062972269658,243659926914.0,0.41660576370046454,0.13170620669898053
950,952,2019-03-17,4047.719482,4054.12207,4006.411133,4025.229004,4025.229004,8221625400.0,3926.410016857138,62.330707896831896,235438301514.0,0.40475920475233274,0.14121332677572068
951,953,2019-03-18,4029.968506,4071.556641,4009.117188,4032.507324,4032.507324,9646954186.0,3945.763602214281,62.822829851826505,245085255700.0,0.4053635236201929,0.06026560786794842
952,954,2019-03-19,4032.691895,4082.216064,4023.8125,4071.190186,4071.190186,9344919956.0,3958.250401214281,65.40935152303962,254430175656.0,0.4135518168655898,0.08166191227208129
953,955,2019-03-20,4070.793945,4089.461914,4031.11084,4087.476318,4087.476318,10175916388.0,3971.3599505714237,66.46712959175511,264606092044.0,0.41038928690848564,0.05954736250181044
954,956,2019-03-21,4083.953857,4097.3598630000015,4005.151367,4029.326904,4029.326904,10831212662.0,3979.777274071424,59.47394954146238,253774879382.0,0.39236124288457175,0.12549683413956705
955,957,2019-03-22,4028.514648,4053.906738,4021.54248,4023.968262,4023.968262,9252935969.0,3988.5513219285667,58.859370867217905,244521943413.0,0.3000665009593581,0.05073423600209315
956,958,2019-03-23,4022.713379,4049.882568,4015.9646,4035.826416,4035.826416,9578850549.0,3993.730800142853,59.84815888771579,254100793962.0,0.438518754228922,0.13780016612451476
957,959,2019-03-24,4035.163574,4040.699707,4006.192871,4022.168213,4022.168213,9144851065.0,3998.771397214281,58.11560717006992,244955942897.0,0.437746002479988,0.12982755885785593
958,960,2019-03-25,4024.112793,4038.84082,3934.03125,3963.070557,3963.070557,10359818883.0,4002.903058785709,51.2079023010472,234596124014.0,0.4015678902618612,0.17564024587225346
959,961,2019-03-26,3969.22876,3985.080811,3944.753174,3985.080811,3985.080811,10707678815.0,4008.326241714281,53.428162384546155,245303802829.0,0.44919488545635383,0.13623842853608115
960,962,2019-03-27,3984.244873,4087.066162,3977.810547,4087.066162,4087.066162,10897131934.0,4021.2083043571392,62.04617840231017,256200934763.0,0.5020647501514046,0.1808064816301161
961,963,2019-03-28,4087.584473,4094.9021,4040.266357,4069.107178,4069.107178,9353915899.0,4031.546735571424,59.94264937858954,246847018864.0,0.41066416024096003,0.11820609569901766
962,964,2019-03-29,4068.299805,4113.5009770000015,4034.097168,4098.3745119999985,4098.3745119999985,10918665557.0,4041.3655483571374,62.1922253804475,257765684421.0,0.3941611179377472,0.06534539824113675
963,965,2019-03-30,4092.13623,4296.806640999999,4053.909668,4106.660156,4106.660156,9732688060.0,4045.503714499995,62.82866095019379,267498372481.0,0.4284086372314843,0.11817989344485323
964,966,2019-03-31,4105.456055,4113.023438,4094.10083,4105.404297,4105.404297,9045122443.0,4051.230521142853,62.65649837708528,258453250038.0,0.4238688066049177,0.10680674662271884
965,967,2019-04-01,4105.362305,4164.953125,4096.901367,4158.183105,4158.183105,10157794171.0,4060.2073626428523,66.77677274564287,268611044209.0,0.45853499662276254,0.10172983507823934
966,968,2019-04-02,4156.919434,4905.95459,4155.316895,4879.87793,4879.87793,21315047816.0,4117.9707729285665,87.34238560783193,289926092025.0,0.3898499584899723,0.0906504573381504
967,969,2019-04-03,4879.958008,5307.003418,4876.621094,4973.021973,4973.021973,22899891582.0,4181.224033999995,88.34513682079316,312825983607.0,0.4209869807346456,0.05965764969897935
968,970,2019-04-04,4971.307617,5063.159668,4836.793945,4922.798828,4922.798828,18251810240.0,4245.043457142852,84.45983238751367,294574173367.0,0.4587944798250269,0.15448818234422337
969,971,2019-04-05,4922.806152,5053.509765999999,4919.491699,5036.681152,5036.681152,16837325387.0,4317.380092142852,85.96690121843342,311411498754.0,0.43030252390361834,0.10401421502278776
970,972,2019-04-06,5036.792969,5205.821777,4992.222168,5059.817383,5059.817383,16929795194.0,4390.522304071424,86.25846502439829,328341293948.0,0.3946255909356642,0.10967567250348735
971,973,2019-04-07,5062.793945,5235.1865229999985,5050.412109000001,5198.896973,5198.896973,16655416140.0,4474.574358357138,87.88762856404375,344996710088.0,0.420515818164941,0.11382274499379763
972,974,2019-04-08,5199.835449,5318.836426,5148.211914,5289.770996,5289.770996,17154113634.0,4569.338675428568,88.8202840322637,362150823722.0,0.40403482652824757,0.09090484418115996
973,975,2019-04-09,5289.917969,5289.917969,5167.418945,5204.958496,5204.958496,14722104361.0,4656.472795785711,82.44007057128006,347428719361.0,0.35109237603355253,0.07929800809212573
974,976,2019-04-10,5204.105469,5421.651367,5193.382324,5324.551758,5324.551758,15504590933.0,4744.864624071424,84.16715490336594,362933310294.0,0.43796236012790296,0.1452491829043311
975,977,2019-04-11,5325.081543,5354.225586,5017.2963869999985,5064.487793,5064.487793,16555616019.0,4815.963239428566,68.41027380018973,346377694275.0,0.46953031543949364,0.1253856941264064
976,978,2019-04-12,5061.200684,5103.274414,4955.852539,5089.539063,5089.539063,13675206312.0,4886.760707357139,69.01207677987445,360052900587.0,0.3606874086629747,0.0872263414195746
977,979,2019-04-13,5088.850098,5127.12207,5061.589355,5096.586426,5096.586426,10823289598.0,4957.469726642853,69.18989783709148,370876190185.0,0.37723220155065396,0.08629176759087474
978,980,2019-04-14,5095.758789,5184.0161130000015,5053.568359000001,5167.722168,5167.722168,10391952498.0,5033.349574571424,70.99894708454367,381268142683.0,0.426558350225839,0.07419899918722729
979,981,2019-04-15,5167.321777,5196.606934,5024.069336,5067.1083979999985,5067.1083979999985,12290155061.0,5098.272809785709,65.17038067650603,368977987622.0,0.4064484315087884,0.03238860568525436
980,982,2019-04-16,5066.5776369999985,5238.945313,5055.194824,5235.55957,5235.55957,11618660197.0,5123.67864121428,69.66105548198361,380596647819.0,0.39812258100762865,0.07598534912692437
981,983,2019-04-17,5236.135254,5274.275390999999,5219.205566,5251.9379880000015,5251.9379880000015,12438480677.0,5143.601213714281,70.06518636026138,393035128496.0,0.4122622612916641,0.1709380373862363
982,984,2019-04-18,5251.480469,5319.986328,5250.506836,5298.385742,5298.385742,13256489918.0,5170.428850428566,71.2353798076902,406291618414.0,0.40463242372297986,0.13196373298327746
983,985,2019-04-19,5298.154297,5336.680176,5233.334961,5303.8125,5303.8125,13780238655.0,5189.5096609999955,71.37616898869489,420071857069.0,0.44001077818605,0.10696450717406748
984,986,2019-04-20,5304.160645,5358.490723,5295.87793,5337.88623,5337.88623,13169647522.0,5209.371721499994,72.29315277056881,433241504591.0,0.4377817482808353,0.1781721235388308
985,987,2019-04-21,5335.878906,5359.924805,5257.339355,5314.53125,5314.53125,13731844223.0,5217.631312714279,70.62311884501094,419509660368.0,0.4732785218640482,0.11948462588813465
986,988,2019-04-22,5312.494629,5422.6875,5280.276855,5399.365234000001,5399.365234000001,14601631648.0,5225.459472571422,73.0577698537343,434111292016.0,0.40219113097928194,0.07446400127756214
987,989,2019-04-23,5399.365723,5633.802246,5389.408691,5572.362305,5572.362305,15867308108.0,5251.702601785708,77.20634185166135,449978600124.0,0.3831100989206871,0.06961775296598825
988,990,2019-04-24,5571.508301,5642.044434,5418.263184,5464.866699,5464.866699,17048033399.0,5261.725097571422,69.99420708207211,432930566725.0,0.4272649804330689,0.14275085147315475
989,991,2019-04-25,5466.524414,5542.238281,5181.338867,5210.515625,5210.515625,15330283408.0,5272.155656999994,56.5365937907935,417600283317.0,0.42736179748376985,0.0808521630696392
990,992,2019-04-26,5210.304688,5383.634277,5177.368652,5279.348145,5279.348145,16812108040.0,5285.7134485714205,58.842791993964504,434412391357.0,0.37678139204898403,0.0850188503221377
991,993,2019-04-27,5279.471191,5310.75,5233.635742,5268.291015999999,5268.291015999999,13111274675.0,5297.978062142851,58.30757335647451,421301116682.0,0.4791726307136755,0.16726330558606678
992,994,2019-04-28,5271.746582,5326.231934,5255.683594,5285.13916,5285.13916,12819992056.0,5306.364990142853,58.92070719904808,434121108738.0,0.4103496654655191,0.06597401401669695
993,995,2019-04-29,5284.8583979999985,5311.274902,5216.487793,5247.352539,5247.352539,13735490672.0,5319.239571642852,56.89965098779214,420385618066.0,0.4252875165291541,0.13076646305849268
994,996,2019-04-30,5247.726074,5363.257324,5224.189941,5350.726563,5350.726563,13878964574.0,5327.465785428567,60.85549613535742,434264582640.0,0.39596240666025406,0.09807831997861055
995,997,2019-05-01,5350.914551,5418.003906,5347.645996,5402.697265999999,5402.697265999999,13679528236.0,5338.2343052857095,62.708597051549205,447944110876.0,0.38356550876331497,0.10233175954973908
996,998,2019-05-02,5402.4228520000015,5522.262695,5394.217285,5505.283691,5505.283691,14644460907.0,5353.012730214281,66.11824944523214,462588571783.0,0.46077928461357437,0.16010595295028582
997,999,2019-05-03,5505.552246,5865.881836,5490.20166,5768.289551,5768.289551,18720780006.0,5386.189662428566,72.94744922089305,481309351789.0,0.36392163865308774,0.10796807958117682
998,1000,2019-05-04,5769.2026369999985,5886.893555,5645.4692380000015,5831.16748,5831.16748,17567780766.0,5421.424037428566,74.28206880689527,498877132555.0,0.4503338722320204,0.08511597456041901
999,1001,2019-05-05,5831.068359000001,5833.862793,5708.035156,5795.708496,5795.708496,14808830723.0,5455.793840714281,72.12121662273388,484068301832.0,0.44783764772721585,0.18622826828889694
1000,1002,2019-05-06,5791.693359000001,5802.95752,5653.6875,5746.807129,5746.807129,15737171804.0,5480.611118928567,69.13435976825174,468331130028.0,0.3946669121482708,0.04176685932588999
1001,1003,2019-05-07,5745.599121,5988.178223,5741.395996,5829.501465,5829.501465,18026409033.0,5498.97820178571,71.2990098071154,486357539061.0,0.38640550065550067,0.0477601131976132
1002,1004,2019-05-08,5849.481445,5989.980957,5794.71582,5982.45752,5982.45752,15320605300.0,5535.94897471428,74.81700595408304,501678144361.0,0.4450357500202027,0.10573252207991016
1003,1005,2019-05-09,5982.316406,6183.039063,5982.316406,6174.528809,6174.528809,16784645411.0,5604.807059285708,78.39778288071304,518462789772.0,0.4067408731514726,0.08378870984319393
1004,1006,2019-05-10,6175.822754,6434.617676,6161.519043,6378.849121,6378.849121,19419875368.0,5683.342843285709,81.42373515122405,537882665140.0,0.35176020408163267,0.13148364642412264
1005,1007,2019-05-11,6379.666992,7333.00293,6375.69873,7204.771484000001,7204.771484000001,28867562329.0,5821.66287671428,88.46040001004656,566750227469.0,0.37732924854817174,0.06696883410620517
1006,1008,2019-05-12,7203.507323999998,7503.87207,6815.770995999998,6972.371581999999,6972.371581999999,27773333680.0,5942.179478285708,79.35189364037403,538976893789.0,0.462931359439172,0.1537848258512321
1007,1009,2019-05-13,6971.178223000001,8047.413086,6898.282227,7814.915039,7814.915039,28677672181.0,6125.576799714278,85.27252104866429,567654565970.0,0.4328123297455628,0.07798519889322189
1008,1010,2019-05-14,7807.884276999999,8268.712891,7696.391113,7994.416015999999,7994.416015999999,32031452227.0,6314.41176064285,86.18160559785039,599686018197.0,0.42006185533359447,0.0757594757377366
1009,1011,2019-05-15,7989.374512,8216.423828,7899.106934,8205.167969,8205.167969,28344112920.0,6514.5882394285645,87.1820306724832,628030131117.0,0.45259945375420285,0.16808104699700077
1010,1012,2019-05-16,8194.500977,8320.824219,7729.608398,7884.90918,7884.90918,33167197581.0,6684.56148864285,77.94695856250219,594862933536.0,0.43772593298157136,0.11883381725930375
1011,1013,2019-05-17,7886.925781,7929.145508,7038.124512,7343.895508,7343.895508,30066644905.0,6797.104771285708,65.35279466314105,564796288631.0,0.40831334683273096,0.0946842441362959
1012,1014,2019-05-18,7341.664551000002,7447.271973000001,7251.504395,7271.208008,7271.208008,21354286562.0,6899.964808999993,63.85988182564803,543442002069.0,0.432000596366827,0.09235059331199205
1013,1015,2019-05-19,7267.962890999999,8261.941406,7267.962890999999,8197.689453,8197.689453,25902422040.0,7071.534877357136,72.48706301625123,569344424109.0,0.45029471328621384,0.1476185392066738
1014,1016,2019-05-20,8196.923828,8200.967773,7678.781738,7978.309081999999,7978.309081999999,23843404340.0,7230.927873999993,68.3277446766416,545501019769.0,0.46692943716091334,0.107718783086811
1015,1017,2019-05-21,7977.969238,8062.167969,7843.339844,7963.327637,7963.327637,25127245056.0,7383.344029142851,68.04061998577222,520373774713.0,0.3857718982718983,0.13218272384939053
1016,1018,2019-05-22,7956.291992,7997.612305,7615.987305,7680.066406,7680.066406,24719473175.0,7504.601806714279,62.67766239426739,495654301538.0,0.36269463340891916,0.054633999433106574
1017,1019,2019-05-23,7677.269043000001,7943.791504000002,7533.196776999999,7881.84668,7881.84668,24457107820.0,7626.553083214279,64.80572488869926,520111409358.0,0.46714997109553913,0.11685650010039754
1018,1020,2019-05-24,7881.695312999998,8140.719727,7824.44873,7987.371581999999,7987.371581999999,25919126991.0,7741.447544714279,65.90074321453089,546030536349.0,0.3846999895572264,0.1273588325935164
1019,1021,2019-05-25,7991.885254000002,8117.925781,7965.976073999998,8052.543945,8052.543945,22256813107.0,7802.0027204999915,66.59208363009479,568287349456.0,0.49139864858177573,0.10296811644346834
1020,1022,2019-05-26,8055.206055,8687.520508,7924.67041,8673.21582,8673.21582,26677970091.0,7923.49159464285,72.34298171935912,594965319547.0,0.4628756629578998,0.15840939944558366
1021,1023,2019-05-27,8674.072266,8907.174805,8668.705078,8805.77832,8805.77832,27949839564.0,7994.267543285707,73.39632800779106,622915159111.0,0.4112665028005891,0.0830684386484858
1022,1024,2019-05-28,8802.757813,8807.016602,8634.72168,8719.961914,8719.961914,24226919267.0,8046.092250285706,71.49790304038792,598688239844.0,0.4196187958597089,0.10439221570227777
1023,1025,2019-05-29,8718.591797,8755.852539,8482.728516,8659.487305,8659.487305,23473479966.0,8078.5436314285635,70.1214623623715,575214759878.0,0.47089841713675173,0.14932153903444229
1024,1026,2019-05-30,8661.760742,9008.314453,8221.273438,8319.472656,8319.472656,29246528551.0,8109.583879714279,62.800977596840745,545968231327.0,0.42661902115971095,0.09076043044777439
1025,1027,2019-05-31,8320.286133,8586.65918,8172.550781,8574.501953,8574.501953,25365190957.0,8197.484340071422,65.69390350061926,571333422284.0,0.4590267593389713,0.14722835955007613
1026,1028,2019-06-01,8573.839844,8625.600586,8481.578125,8564.016602,8564.016602,22488303544.0,8289.82781107142,65.468471498642,548845118740.0,0.44894397076143405,0.08693593964422278
1027,1029,2019-06-02,8565.473633,8809.303711,8561.235352,8742.958008,8742.958008,20266216022.0,8328.775564999993,67.51707621575196,569111334762.0,0.4131621141271412,0.08562695775678289
1028,1030,2019-06-03,8741.74707,8743.5,8204.185547,8208.995117,8208.995117,22004511436.0,8345.253138928563,56.70626417776114,547106823326.0,0.4546307918845368,0.14810309876646052
1029,1031,2019-06-04,8210.985352,8210.985352,7564.48877,7707.770995999998,7707.770995999998,24609731549.0,8326.999093142851,48.80628398414025,522497091777.0,0.41293120204726363,0.12225406295912196
1030,1032,2019-06-05,7704.343262,7901.849120999998,7668.668456999999,7824.231445,7824.231445,21760923463.0,8337.296595928565,50.53077621539812,544258015240.0,0.42562010646997583,0.10523326469638243
1031,1033,2019-06-06,7819.633301000002,7937.34082,7571.471191,7822.023437999998,7822.023437999998,19474611077.0,8333.023507214279,50.496045907909405,524783404163.0,0.4117985712469839,0.11152797099820906
1032,1034,2019-06-07,7826.901367,8126.15332,7788.373535,8043.951172,8043.951172,19141423231.0,8337.064906499994,53.92391366077189,543924827394.0,0.4601651667611489,0.13374015988971344
1033,1035,2019-06-08,8036.774901999999,8076.891113,7837.61084,7954.12793,7954.12793,16522722810.0,8330.035191142852,52.34407220330204,527402104584.0,0.38774862895840717,0.09843460061443932
1034,1036,2019-06-09,7949.674805,7975.974120999998,7583.219727,7688.077148,7688.077148,16610726547.0,8259.668143142851,47.87044243099699,510791378037.0,0.4106521093863284,0.13733177311805222
1035,1037,2019-06-10,7692.284668000001,8031.909668000001,7586.730956999999,8000.32959,8000.32959,18689275117.0,8202.136090999995,52.952663606796754,529480653154.0,0.4096394235238773,0.13161088040499808
1036,1038,2019-06-11,8004.243651999999,8026.394043000001,7772.803711,7927.714355,7927.714355,17107279932.0,8145.5469796428515,51.69058173339518,512373373222.0,0.38914905118030124,0.10740395214353547
1037,1039,2019-06-12,7925.434081999999,8196.648438,7862.359863,8145.857422,8145.857422,19034432883.0,8108.859130857138,55.14894590947602,531407806105.0,0.41949993563308896,0.11455344193203056
1038,1040,2019-06-13,8145.54541,8311.567383,8087.061035,8230.923828,8230.923828,18669407147.0,8102.534214571423,56.45797381179931,550077213252.0,0.3608451195629767,0.09825633374561946
1039,1041,2019-06-14,8230.898438,8710.636719,8183.393066,8693.833008,8693.833008,19831162906.0,8111.057861357138,62.81765591238498,569908376158.0,0.44454838498269134,0.0945688350340136
1040,1042,2019-06-15,8689.746094,8859.12793,8618.395508,8838.375,8838.375,18371033226.0,8130.654889785708,64.55835449441551,588279409384.0,0.3811383129732883,0.03420810853076863
1041,1043,2019-06-16,8841.44043,9335.867188,8814.556641,8994.488281,8994.488281,23348550311.0,8148.6213378571365,66.38857826742718,611627959695.0,0.37756855743322065,0.13554346986252358
1042,1044,2019-06-17,8988.923828,9416.407227,8988.923828,9320.352539,9320.352539,15562951919.0,8228.004010857137,69.88450181730049,627190911614.0,0.41372060122103815,0.17783161936740777
1043,1045,2019-06-18,9335.466797,9348.374023,9004.901367,9081.762695,9081.762695,15848210536.0,8326.146275071425,64.58757547004447,611342701078.0,0.4244824491522387,0.12614958987127473
1044,1046,2019-06-19,9078.727539,9299.621094,9070.395508,9273.521484,9273.521484,15546809946.0,8429.666992142851,66.76774789797224,626889511024.0,0.4354562733087628,0.15599182121454133
1045,1047,2019-06-20,9273.060547,9594.419922,9232.484375,9527.160156,9527.160156,17846823784.0,8551.462471999994,69.44711534779718,644736334808.0,0.43507895875206143,0.12448762706787259
1046,1048,2019-06-21,9525.074219,10144.556641,9525.074219,10144.556641,10144.556641,20624008643.0,8701.505719785708,74.77785919634763,665360343451.0,0.4356469549946901,0.11481054657961672
1047,1049,2019-06-22,10175.923828,11157.345703,10107.035156,10701.691406,10701.691406,29995204861.0,8897.76025378571,78.43445403072988,695355548312.0,0.38424128839570015,0.10537696882366002
1048,1050,2019-06-23,10696.691406,11246.144531,10556.095703,10855.371094,10855.371094,20998326502.0,9123.99553564285,79.32485250361397,716353874814.0,0.43305598025015213,0.1258589831762959
1049,1051,2019-06-24,10853.744141,11065.896484,10610.427734,11011.102539,11011.102539,19271652365.0,9339.05074628571,80.21626115747897,735625527179.0,0.34470926602467306,0.15321069918453642
1050,1052,2019-06-25,11007.202148,11790.916992,11007.202148,11790.916992,11790.916992,24879684533.0,9614.993791785708,83.94831923471259,760505211712.0,0.410993904344307,0.0949319018108409
1051,1053,2019-06-26,11778.581055,13796.489258,11755.597656,13016.231445,13016.231445,45105733173.0,9962.877650571425,87.83238410046332,805610944885.0,0.4654712800390719,0.08117861126260222
1052,1054,2019-06-27,13017.125,13311.144531,10491.852539,11182.806641,11182.806641,39977475223.0,10173.726422928568,63.19278302251274,765633469662.0,0.4260452801106185,0.10038820813187553
1053,1055,2019-06-28,11162.167969,12445.174805,10914.495117,12407.332031,12407.332031,35087757766.0,10438.97635314285,69.3726342618056,800721227428.0,0.39365615038285845,0.10227977642434587
1054,1056,2019-06-29,12400.763672,12400.910156,11508.378906,11959.371094,11959.371094,29923961128.0,10661.904645571425,65.06862030405243,770797266300.0,0.4396561412093412,0.04579280460545401
1055,1057,2019-06-30,11931.991211,12178.383789,10799.008789,10817.155273,10817.155273,27256473494.0,10792.095144999998,55.59690173517421,743540792806.0,0.3997501967729239,0.10523529122392758
1056,1058,2019-07-01,10796.930664,11206.439453,10089.314453,10583.134766,10583.134766,29378589324.0,10882.293875499998,53.866810999357966,714162203482.0,0.436462250543043,0.11035007650276771
1057,1059,2019-07-02,10588.683594,10912.188477,9737.884766,10801.677734,10801.677734,31015895223.0,11005.144949714284,55.26677261176353,745178098705.0,0.4581612749518827,0.13852692229736877
1058,1060,2019-07-03,10818.15625,11968.078125,10818.15625,11961.269531,11961.269531,30796494294.0,11197.126953071423,61.87734117562349,775974592999.0,0.3261551343868416,0.09802467180515963
1059,1061,2019-07-04,11972.71875,12006.075195,11166.569336,11215.4375,11215.4375,25920294033.0,11317.718191928567,56.131713722262994,750054298966.0,0.4126338087569972,0.06110478490913273
1060,1062,2019-07-05,11203.102539,11395.661133,10874.964844,10978.459961,10978.459961,23838480210.0,11377.282714785713,54.40316809711708,726215818756.0,0.4266068076762014,0.06252574115011277
1061,1064,2019-07-07,11217.616211,11541.620117,11148.804688,11450.84668,11450.84668,19369044277.0,11456.02092628571,57.33491291024365,766676887339.0,0.46466992222296843,0.1418921175113402
1062,1065,2019-07-08,11446.59668,12345.833008,11393.374023,12285.958008,12285.958008,23482551458.0,11547.08203121428,62.136869912124396,790159438797.0,0.4104965183474074,0.0750944768434453
1063,1066,2019-07-09,12284.326172,12779.131836,12233.261719,12573.8125,12573.8125,28167921523.0,11603.003138928567,63.65531757855602,818327360320.0,0.366154330169056,0.05400840680343169
1064,1067,2019-07-10,12571.537109,13129.529297,11710.978516,12156.512695,12156.512695,33627574244.0,11541.594656785708,59.90468958245353,784699786076.0,0.43248469880636103,0.11603511036142483
1065,1068,2019-07-11,12139.713867,12144.623047,11158.922852,11358.662109,11358.662109,28595327690.0,11554.155761642849,53.423433673187844,756104458386.0,0.45519139466976344,0.11062409140306449
1066,1069,2019-07-12,11354.299805,11905.487305,11179.144531,11815.986328,11815.986328,23534692797.0,11511.916782857135,56.339355056708676,779639151183.0,0.42419288381243464,0.08510730753738371
1067,1070,2019-07-13,11813.126953,11841.957031,10908.479492,11392.378906,11392.378906,21042616384.0,11471.417340857137,53.02777118799141,758596534799.0,0.4006728436324024,0.0966673828622358
1068,1071,2019-07-14,11381.020508,11451.204102,10234.576172,10256.058594,10256.058594,22486000001.0,11431.339006642851,45.3305075539264,736110534798.0,0.4818429010423874,0.2128379872600763
1069,1072,2019-07-15,10257.838867,11052.766602,9992.006836,10895.089844,10895.089844,25384047207.0,11453.621512214277,49.74815458727089,761494582005.0,0.43930891754850093,0.12038576101928374
1070,1073,2019-07-16,10896.65332,10996.632813,9448.106445,9477.641602,9477.641602,24151199070.0,11359.047502785706,41.699137648763134,737343382935.0,0.4144336928203849,0.11106983216667429
1071,1074,2019-07-17,9471.213867,9963.134766,9163.134766,9693.802734,9693.802734,24569921549.0,11197.08558871428,43.20819795346578,761913304484.0,0.4376563452181921,0.06941719263357736
1072,1075,2019-07-18,9698.50293,10736.842773,9376.798828,10666.482422,10666.482422,25187024648.0,11157.874511714279,49.537778183774044,787100329132.0,0.42465511391957445,0.06834831059281837
1073,1076,2019-07-19,10653.956055,10716.980469,10229.628906,10530.732422,10530.732422,20727426310.0,11125.893973214275,48.72163605239227,766372902822.0,0.4219737883022166,0.0764589508801237
1074,1077,2019-07-20,10525.819336,11048.662109,10451.276367,10767.139648,10767.139648,20206615155.0,11094.36460657142,50.25856289044663,786579517977.0,0.4072095389162813,0.07506842635847337
1075,1078,2019-07-21,10777.529297,10841.887695,10389.599609,10599.105469,10599.105469,17130580467.0,11033.525948642851,49.131366873643586,769448937510.0,0.4273500705164205,0.09684202091488116
1076,1079,2019-07-22,10596.948242,10651.791016,10154.921875,10343.106445,10343.106445,16334414913.0,10894.750836999996,47.38763471934674,753114522597.0,0.4537615788370545,0.09351867064536555
1077,1080,2019-07-23,10346.748047,10346.748047,9883.594727,9900.767578,9900.767578,17851916995.0,10703.819056857139,44.451925846266356,735262605602.0,0.4270628573890426,0.09133618009700538
1078,1081,2019-07-24,9887.730469,9908.796875,9614.306641,9811.925781,9811.925781,17398734322.0,10536.348562999994,43.86415954542851,717863871280.0,0.4550596205248558,0.08327568203524703
1079,1082,2019-07-25,9809.09668,10154.253906,9773.957031,9911.841797,9911.841797,15821952090.0,10433.004254999994,44.748983419759455,733685823370.0,0.355190698361446,0.09938372451957808
1080,1083,2019-07-26,9913.126953,9916.517578,9717.982422,9870.303711,9870.303711,14495714483.0,10294.026925214279,44.43540813008364,719190108887.0,0.4453518711410924,0.05820007048925794
1081,1084,2019-07-27,9871.165039,10167.320313,9411.521484,9477.677734,9477.677734,16817809536.0,10157.26255578571,41.4768401438549,702372299351.0,0.5105608572974643,0.11087080627705626
1082,1085,2019-07-28,9491.626953,9575.544922,9252.296875,9552.860352,9552.860352,13738687093.0,10107.034109928569,42.269489076395814,716110986444.0,0.4552655570289499,0.07099391879339798
1083,1086,2019-07-29,9548.178711,9681.648438,9472.948242,9519.145508,9519.145508,13791445323.0,10008.752371642851,41.99480274382535,702319541121.0,0.41422568649751185,0.12419863077105141
1084,1087,2019-07-30,9522.329102,9701.759766,9437.335938,9607.423828,9607.423828,13829811132.0,10018.022530642851,43.038581461001606,716149352253.0,0.43694825512812185,0.054621328736053604
1085,1088,2019-07-31,9604.050781,10085.62793,9598.097656,10085.62793,10085.62793,16631520648.0,10046.010044642851,48.450033768615945,732780872901.0,0.36024227490925487,0.13563852678232377
1086,1089,2019-08-01,10077.442383,10446.919922,9922.019531,10399.668945,10399.668945,17165337858.0,10026.951939142851,51.6955090611964,749946210759.0,0.3951502389903423,0.09373114031591627
1087,1090,2019-08-02,10402.042969,10657.953125,10371.013672,10518.174805,10518.174805,17489094082.0,10026.054966499994,52.900555664613435,767435304841.0,0.4640168839875871,0.1752498017244111
1088,1091,2019-08-03,10519.27832,10946.78125,10503.504883,10821.726563,10821.726563,15352685061.0,10029.954031857136,55.93309532154203,782787989902.0,0.3914553540985502,0.06817904177397849
1089,1092,2019-08-04,10821.632813,11009.207031,10620.27832,10970.18457,10970.18457,16530894787.0,10056.459681928565,57.37845344193897,799318884689.0,0.4645561093378155,0.08180030764889729
1090,1093,2019-08-05,10960.735352,11895.091797,10960.735352,11805.65332,11805.65332,23875988832.0,10160.927315857136,64.44591825241886,823194873521.0,0.4700670489001332,0.13611022296177694
1091,1094,2019-08-06,11811.544922,12273.821289,11290.731445,11478.168945,11478.168945,23635107660.0,10273.598842071424,60.229998282942155,799559765861.0,0.4288095835547286,0.11442241847211751
1092,1095,2019-08-07,11476.193359,12036.990234,11433.701172,11941.96875,11941.96875,22194988641.0,10425.744768428569,63.83805521831199,821754754502.0,0.43706321357568373,0.13345240572271874
1093,1096,2019-08-08,11954.040039,11979.419922,11556.167969,11966.407227,11966.407227,19481591730.0,10572.499441999997,64.02326663718168,841236346232.0,0.3681620982712073,0.14515175233184863
1094,1097,2019-08-09,11953.469727,11970.458008,11709.745117,11862.936523,11862.936523,18339989960.0,10714.830357142851,62.5622462915623,822896356272.0,0.43667229536253827,0.12366605828645405
1095,1098,2019-08-10,11861.556641,11915.655273,11323.898438,11354.024414,11354.024414,18125355447.0,10848.855119999997,55.815653299500894,804771000825.0,0.43565958815958794,0.11699485199485203
1096,1099,2019-08-11,11349.740234,11523.579102,11248.294922,11523.579102,11523.579102,15774371518.0,10989.620744999997,57.46156081707486,820545372343.0,0.3240228223091126,0.08215269211572976
1097,1100,2019-08-12,11528.189453,11528.189453,11320.951172,11382.616211,11382.616211,13647198229.0,11122.725795214279,55.60697910642233,806898174114.0,0.4459981763235894,0.09338838627357918
1098,1101,2019-08-13,11385.052734,11420.049805,10830.327148,10895.830078,10895.830078,16681503537.0,11214.754813071424,49.64779745647432,790216670577.0,0.399316674860416,0.06807382065705633
1099,1102,2019-08-14,10889.487305,10889.556641,10028.135742,10051.704102,10051.704102,19990838300.0,11212.331682499995,41.36870078681166,770225832277.0,0.4348128777625286,0.09795025985744969
1100,1103,2019-08-15,10038.421875,10437.411133,9675.316406,10311.545898,10311.545898,22899115082.0,11206.037179142852,44.440063688441036,793124947359.0,0.4419596451412707,0.12032184937356745
1101,1104,2019-08-16,10319.419922,10524.349609,9855.478516,10374.338867,10374.338867,20228207096.0,11195.763183571426,45.18731958135003,813353154455.0,0.3937672456270017,0.10258093486336281
1102,1105,2019-08-17,10358.722656,10452.625,10086.698242,10231.744141,10231.744141,13778035685.0,11153.621581999994,43.748366673316966,799575118770.0,0.4016038593426501,0.04567901697487294
1103,1106,2019-08-18,10233.005859,10487.070313,10119.094727,10345.810547,10345.810547,12999813869.0,11109.023437499995,45.25030023128135,812574932639.0,0.4439914442700157,0.08303929879644167
1104,1107,2019-08-19,10350.283203,10916.053711,10313.204102,10916.053711,10916.053711,16038264603.0,11045.48060828571,52.1313372196189,828613197242.0,0.46198277643427776,0.13298663131808802
1105,1108,2019-08-20,10916.34668,10947.041992,10618.960938,10763.232422,10763.232422,15053082175.0,10994.413713785709,50.306578752974474,813560115067.0,0.38498289988552714,0.09497066941503936
1106,1109,2019-08-21,10764.572266,10798.729492,9962.72168,10138.049805,10138.049805,19473084768.0,10865.562360571425,43.585268175140286,794087030299.0,0.39219398384353743,0.09311041135204082
1107,1110,2019-08-22,10142.521484,10232.996094,9831.462891,10131.055664,10131.055664,17097508856.0,10734.465820357136,43.51522230092068,776989521443.0,0.3972890720804417,0.05802200804564937
1108,1111,2019-08-23,10136.30957,10442.443359,10078.192383,10407.964844,10407.964844,15627023886.0,10630.539271857137,47.13747226729418,792616545329.0,0.402648645750491,0.05894630714232614
1109,1112,2019-08-24,10407.644531,10418.020508,9982.296875,10159.960938,10159.960938,15451030650.0,10545.249023571425,44.391758906467686,777165514679.0,0.45602472349032125,0.08595337347011454
1110,1113,2019-08-25,10160.737305,10304.62207,10008.789063,10138.517578,10138.517578,14153856610.0,10446.316057571425,44.15228341393268,763011658069.0,0.4482777014652015,0.1391290815665816
1111,1114,2019-08-26,10126.299805,10512.328125,10126.299805,10370.820313,10370.820313,18438654080.0,10374.044921999995,47.459044785790844,781450312149.0,0.4237852110062864,0.11671142462099449
1112,1115,2019-08-27,10372.826172,10381.328125,10087.300781,10185.5,10185.5,14762609503.0,10323.307059285711,45.16172555845654,766687702646.0,0.41935067650580665,0.059260749841260396
1113,1116,2019-08-28,10203.426758,10279.366211,9716.65625,9754.422852,9754.422852,17603790323.0,10302.072684285711,40.27764234263394,749083912323.0,0.4221619787002161,0.10961520148243753
1114,1117,2019-08-29,9756.786133,9756.786133,9421.629883,9510.200195,9510.200195,17045878501.0,10244.833705499996,37.784528182215745,732038033822.0,0.4598598652587156,0.13447999395356944
1115,1118,2019-08-30,9514.844727,9656.124023,9428.302734,9598.173828,9598.173828,13595263986.0,10189.393345571425,39.243418733207356,745633297808.0,0.4501529361256794,0.11749740668368276
1116,1119,2019-08-31,9597.539063,9673.220703,9531.799805,9630.664063,9630.664063,11454806419.0,10146.45905428571,39.804816990813706,757088104227.0,0.4446177062374245,0.18588195841716967
1117,1120,2019-09-01,9630.592773,9796.755859,9582.944336,9757.970703,9757.970703,11445355859.0,10104.470493999996,42.06378829041625,768533460086.0,0.3821171536796537,0.09428062133944484
1118,1121,2019-09-02,9757.473633,10396.591797,9730.650391,10346.760742,10346.760742,17248102294.0,10063.806710499995,51.1875451835112,785781562380.0,0.42066268227277676,0.0993490752934585
1119,1122,2019-09-03,10345.725586,10736.104492,10308.547852,10623.540039,10623.540039,19384917989.0,10053.828683142852,54.791670638476326,805166480369.0,0.4234354583975129,0.11292841309026487
1120,1123,2019-09-04,10621.180664,10762.644531,10434.709961,10594.493164,10594.493164,16742664769.0,10086.43178021428,54.33822503454007,788423815600.0,0.4152805768163245,0.08945628177669385
1121,1124,2019-09-05,10588.183594,10627.269531,10516.417969,10575.533203,10575.533203,14551239508.0,10118.180175857142,54.02394294022934,773872576092.0,0.47544754409196344,0.16167504828818388
1122,1125,2019-09-06,10578.198242,10898.761719,10292.299805,10353.302734,10353.302734,19536574783.0,10114.275739428567,50.34816960072585,754336001309.0,0.3971943770083517,0.13258068761244807
1123,1126,2019-09-07,10353.931641,10558.673828,10348.918945,10517.254883,10517.254883,15307366476.0,10139.796735499996,52.89459735959461,769643367785.0,0.4160012246207899,0.13634407742016436
1124,1127,2019-09-08,10518.114258,10595.637695,10409.09082,10441.276367,10441.276367,13670567493.0,10161.422363285712,51.57454879138139,755972800292.0,0.46469610245136445,0.15491745960994302
1125,1128,2019-09-09,10443.228516,10450.311523,10144.929688,10334.974609,10334.974609,17595943368.0,10158.861955857139,49.705513577802755,738376856924.0,0.39908045757124383,0.11157665217241948
1126,1129,2019-09-10,10336.408203,10394.353516,10020.573242,10115.975586,10115.975586,14906809639.0,10153.89592628571,46.00648636103898,723470047285.0,0.40497814751904065,0.09807273002904869
1127,1130,2019-09-11,10123.035156,10215.948242,9980.776367,10178.37207,10178.37207,15428063426.0,10184.178013285711,47.211860694465074,738898110711.0,0.43317066383388414,0.10901015099828584
1128,1131,2019-09-12,10176.819336,10442.253906,10099.242188,10410.126953,10410.126953,15323563925.0,10248.458495999996,51.53923144649914,754221674636.0,0.44800261561201016,0.1481059368585168
1129,1132,2019-09-13,10415.362305,10441.489258,10226.59668,10360.546875,10360.546875,14109864675.0,10302.91371364285,50.58388060446258,740111809961.0,0.45187311605368224,0.08746043984316113
1130,1133,2019-09-14,10345.40332,10422.133789,10291.694336,10358.048828,10358.048828,13468713124.0,10354.869768285711,50.53305546323382,726643096837.0,0.4472809435537202,0.0800800268864522
1131,1134,2019-09-15,10356.46582,10387.035156,10313.092773,10347.712891,10347.712891,12043433567.0,10396.994210285711,50.307820459858654,714599663270.0,0.40219865384515924,0.06337102140193539
1132,1135,2019-09-16,10347.222656,10386.867188,10189.744141,10276.793945,10276.793945,15160167779.0,10391.996581928568,48.70376291323032,699439495491.0,0.45326533919934714,0.1582538383665628
1133,1136,2019-09-17,10281.513672,10296.771484,10199.739258,10241.272461,10241.272461,15304603363.0,10364.69175492857,47.88027991826429,684134892128.0,0.42578447526398094,0.15248906434243983
1134,1137,2019-09-18,10247.795898,10275.928711,10191.469727,10198.248047,10198.248047,16169268880.0,10336.388532285711,46.84708272835071,667965623248.0,0.45499941676620775,0.1389507677837651
1135,1138,2019-09-19,10200.496094,10295.668945,9851.692383,10266.415039,10266.415039,19937691247.0,10314.308663428568,48.734615935043315,687903314495.0,0.3759879004308276,0.08580810142987236
1136,1139,2019-09-20,10266.318359,10285.87207,10132.186523,10181.641602,10181.641602,14734189639.0,10302.047153999996,46.52204775521411,673169124856.0,0.4395431490335355,0.11022841736396194
1137,1140,2019-09-21,10183.648438,10188.097656,10000.708008,10019.716797,10019.716797,13425266806.0,10266.508719285712,42.54847316801618,659743858050.0,0.43462344432190164,0.11565784277565483
1138,1141,2019-09-22,10024.115234,10074.444336,9922.533203,10070.392578,10070.392578,13199651698.0,10240.017020071424,44.156045282894276,672943509748.0,0.44499670960897814,0.044985451148645585
1139,1142,2019-09-23,10067.962891,10074.238281,9727.143555,9729.324219,9729.324219,15144925408.0,10196.756277928567,36.710666133077005,657798584340.0,0.44508180893033406,0.1341363499721329
1140,1143,2019-09-24,9729.321289,9804.317383,8370.801758,8620.566406,8620.566406,25002886689.0,10089.941336499996,23.08403859563002,632795697651.0,0.40105843367171706,0.0836988297822757
1141,1144,2019-09-25,8603.428711,8744.828125,8325.396484,8486.993164,8486.993164,21744728353.0,9969.128557499997,22.023445393097973,611050969298.0,0.4491912320483749,0.0805668826874184
1142,1145,2019-09-26,8487.669922,8515.685547,7895.629395,8118.967773,8118.967773,19258205289.0,9805.474330357141,19.38126660096016,591792764009.0,0.3694784208421236,0.05689946280988486
1143,1146,2019-09-27,8113.101073999998,8271.520508,7965.922852,8251.845703,8251.845703,16408941156.0,9654.852818071424,22.97438769878329,608201705165.0,0.4461444973403456,0.12468876156252917
1144,1147,2019-09-28,8251.273438,8285.617188,8125.431640999999,8245.915039,8245.915039,14141152736.0,9503.986118857141,22.9252759267481,594060552429.0,0.4282681503016084,0.04863027970687526
1145,1148,2019-09-29,8246.037109,8261.707031,7990.49707,8104.185547,8104.185547,13034629109.0,9343.734165714282,21.72980483535216,581025923320.0,0.44020646133543967,0.0698921589019694
1146,1149,2019-09-30,8104.226562999998,8314.231445,7830.758789,8293.868164,8293.868164,17115474183.0,9202.096609928569,27.201230830139128,598141397503.0,0.3949565171208938,0.07152861394404682
1147,1150,2019-10-01,8299.720703,8497.692383,8232.679688,8343.276367,8343.276367,15305343413.0,9066.52546035714,28.60130358524624,613446740916.0,0.37067753162716927,0.07056397799260344
1148,1151,2019-10-02,8344.212891,8393.041992,8227.695313,8393.041992,8393.041992,13125712443.0,8937.582170714284,30.06033684326836,626572453359.0,0.42065905637200096,0.10243060109414791
1149,1152,2019-10-03,8390.774414,8414.227539,8146.437012,8259.992188,8259.992188,13668823409.0,8794.266252785712,28.3899792928156,612903629950.0,0.34970683661491814,0.0717558825103468
1150,1153,2019-10-04,8259.494141,8260.055664,8151.236816,8205.939453,8205.939453,13139456229.0,8653.144670714284,27.716170091159448,599764173721.0,0.47160369626207155,0.10380697811273441
1151,1154,2019-10-05,8210.149414,8215.526367,8071.120605,8151.500488,8151.500488,12200497197.0,8519.700648642856,27.020595596500826,587563676524.0,0.458621173416426,0.1461527671378479
1152,1155,2019-10-06,8149.876953,8161.410156,7958.850586,7988.155762,7988.155762,13160830305.0,8370.969447499998,24.99374513438434,574402846219.0,0.44800464272146623,0.101040921064526
1153,1156,2019-10-07,7989.120605,8308.450195,7905.766113,8245.623047,8245.623047,18009742607.0,8264.99079235714,33.465533352416074,592412588826.0,0.4536062943284502,0.07936602378245526
1154,1157,2019-10-08,8246.849609,8332.714844,8185.763184,8228.783203,8228.783203,15592264032.0,8237.006277857141,33.201393087090175,576820324794.0,0.4428969455380852,0.10028276858739349
1155,1158,2019-10-09,8229.84082,8627.706055,8169.298828,8595.740234,8595.740234,19384942333.0,8244.773925714284,43.64055024783661,596205267127.0,0.4232408238967438,0.1205170839319705
1156,1159,2019-10-10,8585.280273,8625.272461,8471.933594,8586.473633,8586.473633,17618660671.0,8278.16720142857,43.455863239783405,578586606456.0,0.4596642592296202,0.12283783706380508
1157,1160,2019-10-11,8585.262695,8721.780273,8316.181641,8321.756836,8321.756836,19604381101.0,8283.160853785714,38.449906063151744,558982225355.0,0.3745110331100232,0.09727748488422429
1158,1161,2019-10-12,8315.665039,8415.242188,8313.34082,8336.555664,8336.555664,14532641605.0,8289.635184142857,38.87383824045764,573514866960.0,0.42293021958303484,0.13239186750904855
1159,1162,2019-10-13,8336.902344,8470.988281,8276.612305,8321.005859,8321.005859,13808286059.0,8305.122349285713,38.573205895112565,559706580901.0,0.3750747265012318,0.10709177261739607
1160,1163,2019-10-14,8320.832031,8390.208984,8284.130859,8374.686523,8374.686523,15151387859.0,8310.895089214284,40.289941420712424,574857968760.0,0.3961093922436227,0.07823318925725757
1161,1164,2019-10-15,8373.458008,8410.714844,8182.706543000001,8205.369141,8205.369141,15220412632.0,8301.044573071427,36.79674286859071,559637556128.0,0.3790208499695466,0.04164561739986212
1162,1165,2019-10-16,8204.674805,8216.8125,7985.089844,8047.526855,8047.526855,16071646996.0,8276.36492042857,33.850314768634966,543565909132.0,0.4207904096479972,0.10061301622623908
1163,1166,2019-10-17,8047.8125,8134.831543000001,8000.942870999998,8103.911133,8103.911133,14313052244.0,8265.216273642856,35.827091135808935,557878961376.0,0.415995550763896,0.11068094970752873
1164,1167,2019-10-18,8100.933594,8138.413573999998,7902.164062999998,7973.20752,7973.20752,15651592610.0,8248.592564142857,33.339904569901556,542227368766.0,0.38672812039309057,0.06943878234262756
1165,1168,2019-10-19,7973.803711,8082.629395,7944.776855,7988.560547,7988.560547,13797825640.0,8236.95399692857,33.920209918889945,556025194406.0,0.43925963118948264,0.11705421048687928
1166,1169,2019-10-20,7997.807129000002,8281.818359,7949.439453,8222.078125,8222.078125,15504249442.0,8253.662737142857,42.16686158525754,571529443848.0,0.4091209913851686,0.10892472183315517
1167,1170,2019-10-21,8225.115234,8296.694336,8196.416016,8243.720703,8243.720703,15868748866.0,8253.52685542857,42.87837589694939,587398192714.0,0.42468107210851597,0.0834252004928374
1168,1171,2019-10-22,8243.402344,8296.651367,8074.462890999999,8078.203125,8078.203125,16803377857.0,8242.771135571427,38.9333614678848,570594814857.0,0.4507560118138822,0.1093321381953313
1169,1172,2019-10-23,8076.228515999999,8092.999512,7469.322754000002,7514.671875,7514.671875,21942878958.0,8165.551967071427,29.11252113049716,548651935899.0,0.3885965776793078,0.05758620206836069
1170,1173,2019-10-24,7509.728026999999,7532.867676000002,7446.98877,7493.48877,7493.48877,16268708849.0,8087.4816197142845,28.818247992170047,532383227050.0,0.4304835334856293,0.0916219809435188
1171,1174,2019-10-25,7490.703125,8691.540039,7479.984375,8660.700195,8660.700195,28705065488.0,8111.691859642857,55.5061865106396,561088292538.0,0.4015772793755075,0.02559588345743996
1172,1175,2019-10-26,8667.577148,10021.744141,8662.62207,9244.972656,9244.972656,44496255609.0,8176.578787642857,62.987034185254544,605584548147.0,0.4300974500645553,0.08320073977557531
1173,1176,2019-10-27,9241.707031,9749.529297,9112.541992,9551.714844,9551.714844,32593129501.0,8264.486572285712,66.20003077231786,638177677648.0,0.43347448502264363,0.06937531852170473
1174,1177,2019-10-28,9565.101563,9805.118164,9256.148438,9256.148438,9256.148438,30948255332.0,8327.448137642856,60.72958249020604,607229422316.0,0.3932449754230883,0.05151856958320026
1175,1178,2019-10-29,9248.44043,9516.180664,9232.648438,9427.6875,9427.6875,28426779937.0,8414.756591857142,62.65822749861093,635656202253.0,0.3829360195439702,0.06233684434405413
1176,1179,2019-10-30,9422.462891,9426.874023,9085.370117,9205.726563,9205.726563,27706531577.0,8497.48514242857,58.64480805708007,607949670676.0,0.43433340574883905,0.10527049695417215
1177,1180,2019-10-31,9202.458008,9383.161133,9028.717773,9199.584961,9199.584961,26583653947.0,8575.747558714285,58.53308888953835,581366016729.0,0.37271654751407457,0.05931602933577681
1178,1181,2019-11-01,9193.992188,9275.657227,9132.047852,9261.104492,9261.104492,24324691031.0,8667.740199571428,59.368079330995684,605690707760.0,0.44745559682933816,0.12202723363469115
1179,1182,2019-11-02,9259.783203,9377.486328,9249.587891,9324.717773,9324.717773,21242676385.0,8763.18000142857,60.259198735495254,626933384145.0,0.42412042633726116,0.05885653819364166
1180,1183,2019-11-03,9324.787109,9379.806641,9141.251953,9235.354492,9235.354492,21132220847.0,8835.556884785712,58.32405920741855,605801163298.0,0.41464986470100434,0.07662345336645153
1181,1184,2019-11-04,9235.607422,9505.051758,9191.485352,9412.612305,9412.612305,26170255634.0,8919.049142071426,60.99946959774653,631971418932.0,0.39419422641802004,0.06875638279179339
1182,1185,2019-11-05,9413.004883,9457.417969,9256.931641,9342.527344,9342.527344,26198609048.0,9009.358014857142,59.376451476119925,605772809884.0,0.4089433447194885,0.10141606717470397
1183,1186,2019-11-06,9340.864258,9423.237305,9305.90918,9360.879883,9360.879883,23133895765.0,9141.230015428568,59.67899278772018,628906705649.0,0.387568638584479,0.10320267720225625
1184,1187,2019-11-07,9352.393555,9368.476563,9202.353516,9267.561523,9267.561523,22700383839.0,9267.949497785712,57.34056262697472,606206321810.0,0.42957634147692564,0.09378026045502441
1185,1188,2019-11-08,9265.368164,9272.759766,8775.53418,8804.880859,8804.880859,24333037836.0,9278.248116642857,47.41948802289691,581873283974.0,0.4073644485118365,0.0767314903042515
1186,1189,2019-11-09,8809.46875,8891.818359,8793.163086,8813.582031,8813.582031,17578630606.0,9247.434500571428,47.60309260139427,599451914580.0,0.3907241834260447,0.05878668909894841
1187,1190,2019-11-10,8812.489258,9103.826172,8806.162109,9055.526367,9055.526367,20587919881.0,9211.9924665,52.563255734075355,620039834461.0,0.3962375332263898,0.06856806436990547
1188,1191,2019-11-11,9056.917969,9081.279297,8700.608398,8757.788086,8757.788086,20265510765.0,9176.3952985,46.70393011410614,599774323696.0,0.4169671757537793,0.07455514660063191
1189,1192,2019-11-12,8759.751953,8853.768555,8685.427734,8815.662109,8815.662109,20309769107.0,9132.679199142858,47.91921084507772,620084092803.0,0.4334616666121832,0.08624416784260465
1190,1193,2019-11-13,8812.033203,8836.841797,8761.651367,8808.262695,8808.262695,17545755405.0,9104.288922857144,47.76923268197962,602538337398.0,0.4625682791789374,0.17282934763856497
1191,1194,2019-11-14,8811.936523,8826.943359,8692.551758,8708.094727,8708.094727,19084739975.0,9069.182477571429,45.684715322952115,583453597423.0,0.3899436866853529,0.060735652101359804
1192,1195,2019-11-15,8705.708008,8730.873047,8484.84375,8491.992188,8491.992188,21796856471.0,9014.24588442857,41.47933986443217,561656740952.0,0.44787730681741106,0.09702923205266956
1193,1196,2019-11-16,8491.166016,8591.99707,8473.973633,8550.760742,8550.760742,16495389808.0,8958.963239357143,43.01558240052771,578152130760.0,0.41940193970806217,0.09095123366807041
1194,1197,2019-11-17,8549.470703,8727.789063,8500.967773,8577.975586,8577.975586,18668638897.0,8912.007603214286,43.75196489020334,596820769657.0,0.4352046557609058,0.1012267982017982
1195,1198,2019-11-18,8573.980469,8653.280273,8273.573242,8309.286133,8309.286133,21579470673.0,8833.19859092857,38.4667538800248,575241298984.0,0.4229371218937323,0.0761976935733296
1196,1199,2019-11-19,8305.134766,8408.516602,8099.963379000002,8206.145508,8206.145508,21083613816.0,8752.028459785713,36.637177275923904,554157685168.0,0.38271035652793195,0.10355236201627986
1197,1200,2019-11-20,8203.613281,8237.240234,8010.511719,8027.268066,8027.268066,20764300437.0,8656.770472857144,33.64810655651044,533393384731.0,0.4108165794922604,0.12884446325911725
1198,1201,2019-11-21,8023.644531,8110.098145,7597.381836,7642.75,7642.75,22514243371.0,8540.712506928572,28.30262579695361,510879141360.0,0.43000914154408537,0.11339954782881631
1199,1202,2019-11-22,7643.569336,7697.382812999998,6936.706543000001,7296.577637,7296.577637,34242315785.0,8432.9765625,24.525176767097875,476636825575.0,0.4187048718659913,0.06964910276982018
1200,1203,2019-11-23,7296.164551000002,7442.258789,7151.417969,7397.796875,7397.796875,21008924418.0,8331.849051357143,27.569217200488158,497645749993.0,0.3952443191318598,0.11619690572834854
1201,1204,2019-11-24,7398.633789,7408.577148,7029.289062999998,7047.916992,7047.916992,30433517289.0,8188.448381714285,23.9703683094894,467212232704.0,0.38570204122005936,0.08411325600681933
1202,1205,2019-11-25,7039.977051000002,7319.856934,6617.166992,7146.133789,7146.133789,42685231262.0,8073.330217642856,26.856821274553862,509897463966.0,0.4210589469013278,0.09418592986218297
1203,1206,2019-11-26,7145.15918,7320.230469,7098.572265999999,7218.371094,7218.371094,21129505542.0,7959.238002285715,28.992072057137946,531026969508.0,0.436345320568278,0.11541023607123556
1204,1207,2019-11-27,7220.880859000001,7619.693359000001,6974.174316,7531.663573999998,7531.663573999998,23991412764.0,7868.052350785715,37.51215332616447,555018382272.0,0.3576347929427318,0.05997075644252144
1205,1208,2019-11-28,7536.820312999998,7730.072754000002,7454.121581999999,7463.105956999999,7463.105956999999,19050116751.0,7779.1245815,36.480605514657675,535968265521.0,0.4099774180919956,0.09896518589807783
1206,1209,2019-11-29,7466.727051000002,7781.179687999998,7460.756348000001,7761.243651999999,7761.243651999999,19709695456.0,7726.928257500002,43.72761084677078,555677960977.0,0.36450194319286283,0.054727448781531275
1207,1210,2019-11-30,7764.057129000002,7836.102051000002,7515.849609000001,7569.629883,7569.629883,17158194786.0,7656.847481857144,40.527284656746524,538519766191.0,0.42620641602680137,0.06703217584222022
1208,1211,2019-12-01,7571.616211,7571.616211,7291.341797,7424.29248,7424.29248,18720708479.0,7574.441545714287,38.24113510654357,519799057712.0,0.3585573453886592,0.05510649208337346
1209,1212,2019-12-02,7424.036133,7474.818848000001,7233.399414,7321.988281,7321.988281,17082040706.0,7503.92027057143,36.672927843428795,502717017006.0,0.35054952949349505,0.058391817382734884
1210,1213,2019-12-03,7323.975586,7418.858887,7229.356934,7320.145508,7320.145508,14797485769.0,7440.634556285715,36.64377801559645,487919531237.0,0.43905540059826986,0.08819345570782908
1211,1214,2019-12-04,7320.125,7539.784668000001,7170.922852,7252.034668000001,7252.034668000001,21664240918.0,7385.2607421428565,35.51997011453352,466255290319.0,0.39632114098832527,0.05239535912330529
1212,1215,2019-12-05,7253.241698999998,7743.431640999999,7232.676758,7448.307617,7448.307617,18816085231.0,7371.3720005,41.12351207165284,485071375550.0,0.420336567189415,0.07990119736619364
1213,1216,2019-12-06,7450.561523,7546.996581999999,7392.175293000001,7546.996581999999,7546.996581999999,18104466307.0,7389.259068,43.7695832956569,503175841857.0,0.4069650595424447,0.09648832076271453
1214,1217,2019-12-07,7547.265625,7589.95166,7525.711426000002,7556.237793000001,7556.237793000001,15453520564.0,7400.576276428573,44.023278389780295,518629362421.0,0.40406879849641,0.05784744884543856
1215,1218,2019-12-08,7551.338867,7634.606445,7476.091309,7564.345215,7564.345215,15409908086.0,7437.4640066428565,44.260874591280434,534039270507.0,0.392783543303942,0.10026184223973857
1216,1219,2019-12-09,7561.79541,7618.091797,7365.985352,7400.899414,7400.899414,17872021272.0,7455.661551285715,40.526272263661774,516167249235.0,0.4195831519086762,0.09961499298997409
1217,1220,2019-12-10,7397.134276999999,7424.022948999998,7246.043945,7278.119629000002,7278.119629000002,18249031195.0,7459.929303785715,37.93673532203759,497918218040.0,0.42040025653553137,0.06881197666740657
1218,1221,2019-12-11,7277.197754000002,7324.15625,7195.527344,7217.427245999998,7217.427245999998,16350490689.0,7437.483851785715,36.688747510870975,481567727351.0,0.4266892106304818,0.07628098017888525
1219,1222,2019-12-12,7216.73877,7266.639648,7164.741211,7243.134276999999,7243.134276999999,18927080224.0,7421.771588928575,37.62472473147769,500494807575.0,0.3880104510111357,0.0956163743021504
1220,1223,2019-12-13,7244.662109000001,7293.560547,7227.122559,7269.68457,7269.68457,17125736940.0,7386.660225928573,38.633781994634106,517620544515.0,0.3967195631661258,0.09377118899366628
1221,1224,2019-12-14,7268.902831999999,7308.836426000002,7097.208984000001,7124.673828,7124.673828,17137029730.0,7354.8776505714295,35.27708902752151,500483514785.0,0.4132854554304903,0.08306576872694275
1222,1225,2019-12-15,7124.239745999998,7181.075684,6924.375977,7152.301758,7152.301758,16881129804.0,7335.449741857144,36.41069295462149,517364644589.0,0.43257916061624474,0.10989588126425898
1223,1226,2019-12-16,7153.663086,7171.168945,6903.682617,6932.480469,6932.480469,20213265950.0,7307.6277552857155,31.659397550066572,497151378639.0,0.39214631353283497,0.029081410023759063
1224,1227,2019-12-17,6931.31543,6964.075195,6587.974121,6640.5151369999985,6640.5151369999985,22363804217.0,7259.0827287857155,26.679629617752344,474787574422.0,0.4765777488004952,0.04288529336078631
1225,1228,2019-12-18,6647.698242,7324.984863,6540.049316,7276.802734000001,7276.802734000001,31836522778.0,7260.851876357144,46.44860302401345,506624097200.0,0.4105733730563494,0.08023787504653875
1226,1229,2019-12-19,7277.59082,7346.602539,7041.381836,7202.844238,7202.844238,25904604416.0,7243.318777857144,44.932126348300116,480719492784.0,0.3803231496066277,0.07596411929059098
1227,1230,2019-12-20,7208.636719,7257.921875,7086.124023,7218.816406,7218.816406,22633815180.0,7219.877336714287,45.34711540962285,503353307964.0,0.3811759851923316,0.10945828410936952
1228,1231,2019-12-21,7220.59375,7223.226073999998,7112.73584,7191.158691,7191.158691,19312552168.0,7193.800258000001,44.718674604792525,484040755796.0,0.38711581280458823,0.07505516358832685
1229,1232,2019-12-22,7191.188477,7518.033203,7167.179198999998,7511.588867,7511.588867,23134537956.0,7190.031947428573,52.868171413713426,507175293752.0,0.4229777281897185,0.08616711821283786
1230,1233,2019-12-23,7508.902344,7656.17627,7326.192383,7355.628418000001,7355.628418000001,27831788041.0,7186.798304857145,49.07600570055431,479343505711.0,0.35570308444546084,0.07510104364822691
1231,1234,2019-12-24,7354.393066,7535.716797,7269.528809,7322.532227,7322.532227,22991622105.0,7189.970633285717,48.28450909098866,456351883606.0,0.41069011401828,0.09199717033819607
1232,1235,2019-12-25,7325.755859000001,7357.02002,7220.991211,7275.155762,7275.155762,21559505149.0,7194.094098714289,47.113146678156824,434792378457.0,0.41318315567342545,0.0764480672927986
1233,1236,2019-12-26,7274.799316,7388.302734000001,7200.386719,7238.966797,7238.966797,22787010034.0,7193.796421571431,46.191335071887686,412005368423.0,0.4019818093114439,0.14059875749877507
1234,1237,2019-12-27,7238.141113,7363.529297,7189.934081999999,7290.088379000002,7290.088379000002,22777360996.0,7195.253836500003,47.74668013218675,434782729419.0,0.3817018489279202,0.059369023288521255
1235,1238,2019-12-28,7289.03125,7399.041015999999,7286.905273,7317.990234000001,7317.990234000001,21365673026.0,7209.062151214288,48.619621970125216,456148402445.0,0.3879083721696939,0.08451803829766048
1236,1239,2019-12-29,7317.647461,7513.948242,7279.865234000001,7422.652831999999,7422.652831999999,22445257702.0,7228.372942214287,51.867873044824286,478593660147.0,0.4275409515962492,0.11937118699879393
1237,1240,2019-12-30,7420.272948999998,7454.824219,7276.308105,7292.995117,7292.995117,22874131672.0,7254.123988500001,47.83350053304015,455719528475.0,0.46217091803494387,0.06895624670211872
1238,1241,2019-12-31,7294.438965,7335.290039,7169.777831999999,7193.599120999998,7193.599120999998,21167946112.0,7293.629987357143,44.94723834718649,434551582363.0,0.4292071093095035,0.11874900528565922
1239,1242,2020-01-01,7194.89209,7254.330566,7174.944336,7200.174316,7200.174316,18565664997.0,7288.156528928573,45.18287578609066,453117247360.0,0.38077510801307773,0.05428118492309236
1240,1243,2020-01-02,7202.55127,7212.155273,6935.27002,6985.470215,6985.470215,20802083465.0,7272.629813,39.271849094341356,432315163895.0,0.4389613576129419,0.10230380426788663
1241,1244,2020-01-03,6984.428711,7413.715331999999,6914.996094,7344.884276999999,7344.884276999999,28111481032.0,7281.634660928573,50.86106813814306,460426644927.0,0.41272557447664177,0.10411218492898634
1242,1245,2020-01-04,7345.375488,7427.385742,7309.51416,7410.656738,7410.656738,18444271275.0,7297.313092857144,52.64217340327661,478870916202.0,0.40791375030527416,0.1340692132525116
1243,1246,2020-01-05,7410.45166,7544.49707,7400.535645,7411.317383,7411.317383,19725074095.0,7290.1508440000025,52.660734094174316,498595990297.0,0.3691327347555909,0.07238729335507861
1244,1247,2020-01-06,7410.452148,7781.867187999998,7409.292969,7769.219238,7769.219238,23276261598.0,7319.693045428573,61.47069581649495,521872251895.0,0.40959151219943285,0.10545271021530803
1245,1248,2020-01-07,7768.682129000002,8178.21582,7768.227539,8163.692383,8163.692383,28767291327.0,7379.7759137142875,68.44181748536204,550639543222.0,0.38768768090638434,0.07551568253900952
1246,1249,2020-01-08,8161.935547,8396.738281,7956.774414,8079.862793000001,8079.862793000001,31672559265.0,7437.254987357145,65.72051368083967,518966983957.0,0.3891284447630073,0.08554063235878187
1247,1250,2020-01-09,8082.295898,8082.295898,7842.403809,7879.071289,7879.071289,24045990466.0,7482.976736785717,59.60706964388825,494920993491.0,0.4288701915272788,0.0926363789363549
1248,1251,2020-01-10,7878.307617,8166.554198999998,7726.774901999999,8166.554198999998,8166.554198999998,28714583844.0,7545.581438214287,64.67385617462979,523635577335.0,0.3862665427233901,0.11885053817998584
1249,1252,2020-01-11,8162.190918000001,8218.359375,8029.64209,8037.537598000001,8037.537598000001,25521165085.0,7596.977678500001,60.977168595556186,498114412250.0,0.4150695260621731,0.08723297862268452
1250,1253,2020-01-12,8033.261719,8200.063477,8009.059081999999,8192.494141,8192.494141,22903438381.0,7651.966343428574,63.66359504669306,521017850631.0,0.38792120739793035,0.07488500494645955
1251,1254,2020-01-13,8189.771973000001,8197.788086,8079.700684,8144.194336,8144.194336,22482910688.0,7712.7662876428585,62.225638763953725,498534939943.0,0.38847059242167287,0.09295426452313259
1252,1255,2020-01-14,8140.933105,8879.511719,8140.933105,8827.764648,8827.764648,44841784107.0,7829.4923967142895,71.89935444713079,543376724050.0,0.4042998788536771,0.10618574368761169
1253,1256,2020-01-15,8825.34375,8890.117188,8657.1875,8807.010742,8807.010742,40102834650.0,7944.266427142858,71.30231754946068,503273889400.0,0.3843801038742243,0.08970794746438898
1254,1257,2020-01-16,8812.481445,8846.460938,8612.095703,8723.786133,8723.786133,31313981931.0,8068.431849857146,68.83391902058915,471959907469.0,0.41884200666482274,0.1126464571682935
1255,1258,2020-01-17,8725.209961,8958.12207,8677.316406,8929.038086,8929.038086,36372139320.0,8181.585693357146,71.4582159201128,508332046789.0,0.44264110896884007,0.10185281091316231
1256,1259,2020-01-18,8927.211914,9012.198242,8827.332031,8942.808594,8942.808594,32337772627.0,8291.025111642859,71.63080966842313,540669819416.0,0.4033306427368927,0.0934866171637005
1257,1260,2020-01-19,8941.445313,9164.362305,8620.080078,8706.245117,8706.245117,34217320471.0,8383.519949785716,64.42353740686637,506452498945.0,0.40734733303410625,0.07400638019772156
1258,1261,2020-01-20,8704.631836,8745.59082,8560.473633,8657.642578,8657.642578,26422375678.0,8446.978759785716,63.020564440804755,480030123267.0,0.4329777276785718,0.13234726550018186
1259,1262,2020-01-21,8658.991211,8755.706055,8544.520508,8745.894531,8745.894531,24097418512.0,8488.564627500002,64.53100510024417,504127541779.0,0.41988646407705266,0.09540138497896493
1260,1263,2020-01-22,8744.210938,8792.994141,8636.74707,8680.875977,8680.875977,22600204051.0,8531.494140642859,62.50538277925106,481527337728.0,0.387447535456443,0.09693672199640359
1261,1264,2020-01-23,8680.650391,8687.74707,8333.637695,8406.515625,8406.515625,25770680779.0,8569.16873607143,54.702329162134006,455756656949.0,0.4619815496759231,0.14094382440421166
1262,1265,2020-01-24,8405.567383,8514.666992,8266.84082,8445.43457,8445.43457,24397913026.0,8589.08876257143,55.5500308098526,480154569975.0,0.3702185820386063,0.08833826987666875
1263,1266,2020-01-25,8440.119141,8458.453125,8296.21875,8367.847656,8367.847656,19647331549.0,8612.682338142858,53.40439381746457,460507238426.0,0.3634837097588323,0.06262342491710489
1264,1267,2020-01-26,8364.410156,8602.401367,8325.498047,8596.830078,8596.830078,22177678796.0,8641.563476500001,58.49919054627062,482684917222.0,0.4141971754392655,0.11732327884473887
1265,1268,2020-01-27,8597.308594,8977.726563,8597.308594,8909.819336,8909.819336,28647338393.0,8696.250976500001,64.25274884592396,511332255615.0,0.48886043212266056,0.1254716111315089
1266,1269,2020-01-28,8912.524414,9358.589844,8908.447266,9358.589844,9358.589844,34398744403.0,8734.16706192857,70.55590086099387,545731000018.0,0.38330569001788695,0.08424203262233229
1267,1270,2020-01-29,9357.470703,9406.431641,9269.467773,9316.629883,9316.629883,30682598115.0,8770.568429142857,69.3250629819632,515048401903.0,0.431186020905884,0.13235165155539963
1268,1271,2020-01-30,9316.016602,9553.125977,9230.897461,9508.993164,9508.993164,32378792851.0,8826.654645642857,71.75750427294895,547427194754.0,0.4380324055590415,0.11934215814656096
1269,1272,2020-01-31,9508.313477,9521.706055,9230.776367,9350.529297,9350.529297,29432489719.0,8856.761160714283,67.04128717289635,517994705035.0,0.4441724284918817,0.10602436338393015
1270,1273,2020-02-01,9346.357422,9439.323242,9313.239258,9392.875,9392.875,25922656496.0,8888.908761142857,67.65310598901993,543917361531.0,0.4196752458085792,0.05455139316805985
1271,1274,2020-02-02,9389.820313,9468.797852,9217.824219,9344.365234,9344.365234,30835736946.0,8934.4887695,66.13845985651888,513081624585.0,0.39775735620323766,0.030844454574486015
1272,1275,2020-02-03,9344.683594,9540.37207,9248.633789,9293.521484,9293.521484,30934096509.0,8979.908691357143,64.50829296613685,482147528076.0,0.39204317994606885,0.08846490163775551
1273,1276,2020-02-04,9292.841797,9331.265625,9112.811523,9180.962891,9180.962891,29893183716.0,9010.985002785717,60.92798355331702,452254344360.0,0.43546455588705085,0.09834936875525835
1274,1277,2020-02-05,9183.416016,9701.299805,9163.704102,9613.423828,9613.423828,35222060874.0,9077.595563571429,68.22497482239751,487476405234.0,0.4036538852454973,0.12107632862823128
1275,1278,2020-02-06,9617.821289,9824.619141,9539.818359,9729.801758,9729.801758,37628823716.0,9172.116001642858,69.85645126652925,525105228950.0,0.4550121677494777,0.1257847336243997
1276,1279,2020-02-07,9726.00293,9834.716797,9726.00293,9795.943359,9795.943359,34522718159.0,9268.580915142858,70.77486873001202,559627947109.0,0.4048116632835532,0.1389542785057513
1277,1280,2020-02-08,9793.070313,9876.749023,9678.910156,9865.119141,9865.119141,35172043762.0,9375.528878357143,71.74451337318071,594799990871.0,0.39095359675785213,0.10398600973494587
1278,1281,2020-02-09,9863.894531,10129.435547,9850.392578,10116.673828,10116.673828,35807884663.0,9484.089146214286,74.99365982010154,630607875534.0,0.4281420937638297,0.09563637872669437
1279,1282,2020-02-10,10115.55957,10165.765625,9784.563477,9856.611328,9856.611328,39386548075.0,9551.717145642857,66.48223774805378,591221327459.0,0.4079586794872412,0.13416910339746002
1280,1283,2020-02-11,9855.891602,10210.052734,9729.334961,10208.236328,10208.236328,37648059389.0,9612.406180214284,71.2357754673893,628869386848.0,0.42768331580268415,0.09063750673080566
1281,1284,2020-02-12,10202.387695,10393.611328,10202.387695,10326.054688,10326.054688,43444303830.0,9684.507952,72.63612802683042,672313690678.0,0.40756908143908027,0.10662357840595403
1282,1285,2020-02-13,10323.960938,10457.626953,10116.161133,10214.379883,10214.379883,49356071373.0,9734.892717642857,69.19737299002207,622957619305.0,0.4127082960881913,0.05595288542399985
1283,1286,2020-02-14,10211.550781,10321.996094,10125.53418,10312.116211,10312.116211,43338264162.0,9803.577497214283,70.51309240078898,666295883467.0,0.4277992727659038,0.10142099105908768
1284,1287,2020-02-15,10313.856445,10341.555664,9874.427734,9889.424805,9889.424805,43865054831.0,9839.045340428567,58.812738235009604,622430828636.0,0.4168096916101325,0.12172441723567107
1285,1288,2020-02-16,9889.179688,10053.96875,9722.386719,9934.433594,9934.433594,43374780305.0,9881.193080428571,59.58180623539293,665805608941.0,0.3804145474858888,0.08342623587503341
1286,1289,2020-02-17,9936.560547,9938.81543,9507.637695,9690.142578,9690.142578,45998298413.0,9909.523158571426,53.71876812023868,619807310528.0,0.40343930656938376,0.09237501897634788
1287,1290,2020-02-18,9691.230469,10161.935547,9632.382813,10141.996094,10141.996094,47271023953.0,9978.168387357142,61.30372428319836,667078334481.0,0.38925677110969187,0.07048414838857275
1288,1291,2020-02-19,10143.798828,10191.675781,9611.223633,9633.386719,9633.386719,46992019710.0,9979.594308142856,51.14336934767376,620086314771.0,0.39418551572948124,0.09169286211872418
1289,1292,2020-02-20,9629.325195,9643.216797,9507.900391,9608.475586,9608.475586,44925260237.0,9970.928153,50.70014356852986,575161054534.0,0.44607085563130316,0.10394258285173841
1290,1293,2020-02-21,9611.782227,9723.014648,9589.743164,9686.441406,9686.441406,40930547513.0,9963.106584928571,52.09932102529087,616091602047.0,0.41450542376421795,0.1504497905686858
1291,1294,2020-02-22,9687.707031,9698.231445,9600.728516,9663.181641,9663.181641,35838025154.0,9948.682477785711,51.6285574092786,580253576893.0,0.4084668025844199,0.11567290840103546
1292,1295,2020-02-23,9663.318359,9937.404297,9657.791016,9924.515625,9924.515625,41185185761.0,9934.956891857142,56.395870722575594,621438762654.0,0.43295232528681005,0.06699995405853246
1293,1296,2020-02-24,9921.583008,9951.746094,9537.042969,9650.174805,9650.174805,45080496648.0,9920.21142592857,50.74216879851549,576358266006.0,0.42783060619211116,0.11138123258759185
1294,1297,2020-02-25,9651.3125,9652.737305,9305.021484,9341.705078,9341.705078,42515259129.0,9858.316336642854,45.249243144352725,533843006877.0,0.3878911751656357,0.11708967581046349
1295,1298,2020-02-26,9338.290039,9354.77832,8704.426758,8820.522461,8820.522461,50420050762.0,9750.77832042857,37.80320333131653,483422956115.0,0.45852916657559395,0.10968716350724543
1296,1299,2020-02-27,8825.09375,8932.892578,8577.199219,8784.494141,8784.494141,45470195695.0,9648.643624571429,37.34570088398721,437952760420.0,0.3867367860462876,0.05499023589785238
1297,1300,2020-02-28,8788.728516,8890.456055,8492.932617,8672.455078,8672.455078,44605450443.0,9531.524972214283,35.89104244157275,393347309977.0,0.42280430226684007,0.13494060344956477
1298,1301,2020-02-29,8671.212891,8775.631836,8599.508789,8599.508789,8599.508789,35792392544.0,9439.388113928571,34.93687863944116,357554917433.0,0.44801277439866594,0.11664368249765919
1299,1302,2020-03-01,8599.758789,8726.796875,8471.212891,8562.454102,8562.454102,35349164300.0,9341.389578785711,34.436066290411446,322205753133.0,0.4195377745399953,0.08968859077721837
1300,1303,2020-03-02,8563.264648,8921.308594,8532.630859,8869.669922,8869.669922,42857674409.0,9282.784389071428,41.875429987115176,365063427542.0,0.4072273032984303,0.10570640805643124
1301,1304,2020-03-03,8865.387695,8901.598633,8704.990234,8787.786133,8787.786133,42386715821.0,9186.055106142854,40.55459107958642,322676711721.0,0.41531050974143585,0.0829024400104254
1302,1305,2020-03-04,8788.541992,8843.366211,8712.431641,8755.246094,8755.246094,34746706368.0,9123.330775785711,40.014443815681524,287930005353.0,0.40026080494074284,0.08669360206679179
1303,1306,2020-03-05,8760.285156,9142.054688,8757.253906,9078.762695,9078.762695,39698054597.0,9085.494140714283,47.50106460322997,327628059950.0,0.44213539201490226,0.138650996314441
1304,1307,2020-03-06,9078.308594,9167.695313,9032.079102,9122.545898,9122.545898,40826885651.0,9045.215890142854,48.438964352335155,368454945601.0,0.41281846883940193,0.08487460509759254
1305,1308,2020-03-07,9121.600586,9163.220703,8890.744141,8909.954102,8909.954102,36216930370.0,8991.413923071425,44.30050882801643,332238015231.0,0.37563867674625273,0.07522435513655154
1306,1309,2020-03-08,8908.206055,8914.34375,8105.25293,8108.116211,8108.116211,39973102121.0,8861.671107785709,32.887521294284504,292264913110.0,0.4302167224180968,0.09567385485536213
1307,1310,2020-03-09,8111.146484000001,8177.793456999999,7690.098145,7923.644531,7923.644531,46936995808.0,8738.347516785709,30.914291188246214,245327917302.0,0.38070500423235915,0.12272969576540073
1308,1311,2020-03-10,7922.146973000001,8136.945312999998,7814.763184,7909.729492,7909.729492,42213940994.0,8636.063546357138,30.764345604069124,203113976308.0,0.40564193811708954,0.0887568293339989
1309,1312,2020-03-11,7910.089844,7950.814453,7642.8125,7911.430176000002,7911.430176000002,38682762605.0,8571.128383142852,30.808517994424435,241796738913.0,0.394062406117252,0.11721987161475167
1310,1313,2020-03-12,7913.616211,7929.116211,4860.354004,4970.788086,4970.788086,53980357243.0,8298.720807785709,14.080536677263085,187816381670.0,0.4024467666053662,0.08672461371909213
1311,1314,2020-03-13,5017.831055,5838.114746,4106.980957,5563.707031,5563.707031,74156772075.0,8076.667375857138,23.14202446397545,261973153745.0,0.4544621789179731,0.09313671947336971
1312,1315,2020-03-14,5573.0776369999985,5625.226563,5125.069336,5200.366211,5200.366211,36154506008.0,7833.871477428565,21.636141192444754,225818647737.0,0.4484605373976006,0.08347561651060294
1313,1316,2020-03-15,5201.066895,5836.64502,5169.283203,5392.314941,5392.314941,33997889639.0,7607.432965928566,24.43366663366659,259816537376.0,0.41068318642974405,0.0911012095551903
1314,1317,2020-03-16,5385.229492,5385.229492,4575.35791,5014.47998,5014.47998,45368026430.0,7332.06225578571,22.714702315136968,214448510946.0,0.4820034374778299,0.12976537009169406
1315,1318,2020-03-17,5002.578125,5371.348633,4981.90918,5225.629395,5225.629395,38622642935.0,7077.622488785709,25.85404070842145,253071153881.0,0.4691389299031874,0.10470769651699754
1316,1319,2020-03-18,5227.11377,5331.833984000001,5069.335938,5238.4384770000015,5238.4384770000015,37878801016.0,6826.421944714281,26.05028208233077,290949954897.0,0.3978772437620477,0.11389146785728411
1317,1320,2020-03-19,5245.416504,6329.73584,5236.96875,6191.192871,6191.192871,51000731797.0,6620.166957285709,38.9857465407324,341950686694.0,0.4434470433976064,0.10635839157258933
1318,1321,2020-03-20,6191.653809,6844.261719,5865.7817380000015,6198.77832,6198.77832,54442976103.0,6411.326415999995,39.07711808400504,396393662797.0,0.38559413247208274,0.08125975415199019
1319,1322,2020-03-21,6206.521484000001,6378.135254,5932.823242,6185.066406,6185.066406,42494390880.0,6216.691580571423,38.963528265291856,353899271917.0,0.4051767485316774,0.0829595177219282
1320,1323,2020-03-22,6185.558105,6359.697265999999,5823.713867,5830.254883,5830.254883,40099664740.0,6053.987199999995,36.043866329328495,313799607177.0,0.3962691879846809,0.0923813455367446
1321,1324,2020-03-23,5831.3745119999985,6443.93457,5785.004395,6416.314941,6416.314941,46491916000.0,5946.320800714281,43.56604844490961,360291523177.0,0.40379551512107265,0.09866508301514171
1322,1325,2020-03-24,6436.642578,6789.022948999998,6411.066406,6734.803711,6734.803711,48221910672.0,5862.397530642853,47.2004158389264,408513433849.0,0.36885458983072583,0.07309315539944895
1323,1326,2020-03-25,6738.716797,6892.51123,6536.92627,6681.0629880000015,6681.0629880000015,44590107888.0,5774.514160071424,46.654437529941546,363923325961.0,0.4194164626272924,0.10053605848604397
1324,1327,2020-03-26,6675.1708979999985,6735.463867,6590.962890999999,6716.44043,6716.44043,35319797642.0,5899.203613214282,47.088336467026046,399243123603.0,0.4015515827919781,0.07645883857352159
1325,1328,2020-03-27,6719.38916,6793.836426000002,6466.70166,6469.79834,6469.79834,34585598367.0,5963.924420999996,44.378233767897996,364657525236.0,0.3654112808911544,0.04157122826969557
1326,1329,2020-03-28,6467.253906,6467.5009770000015,6117.837890999999,6242.193848,6242.193848,34885225901.0,6038.340680785711,41.97727363066507,329772299335.0,0.35159918125501394,0.07635168951631752
1327,1330,2020-03-29,6245.6245119999985,6250.467285,5920.085938,5922.042969,5922.042969,28373690931.0,6076.178397071424,38.797628387714425,301398608404.0,0.432237404978953,0.09961605366289857
1328,1331,2020-03-30,5925.538574,6517.195801,5903.234375,6429.841797,6429.841797,37101651525.0,6177.275669714281,45.80914720779986,338500259929.0,0.37712629509254997,0.07100662504136962
1329,1332,2020-03-31,6430.606445,6504.5151369999985,6374.162109000001,6438.644531,6438.644531,32786468812.0,6263.9196079999965,45.92479905196024,371286728741.0,0.4131796620716264,0.09501912529270354
1330,1333,2020-04-01,6437.319336,6612.57373,6202.373535,6606.776367,6606.776367,40346426266.0,6361.658028714281,48.19876396720618,411633155007.0,0.3968413302298685,0.054559111242892346
1331,1334,2020-04-02,6606.776367,7088.247559,6595.918457,6793.624512,6793.624512,47660646124.0,6404.68886021428,50.680892924825926,459293801131.0,0.4111419081359558,0.13270048128679082
1332,1335,2020-04-03,6797.396484000001,7003.220703,6673.335938,6733.387206999999,6733.387206999999,38976504903.0,6442.875209285709,49.85156847008246,420317296228.0,0.3969687774362116,0.08805272131793945
1333,1336,2020-04-04,6738.382812999998,6878.953613,6696.4848630000015,6867.527344,6867.527344,33185988584.0,6491.622419142852,51.74521322958388,453503284812.0,0.38681780379587055,0.07573258331659409
1334,1337,2020-04-05,6862.537598000001,6883.414062999998,6715.929198999998,6791.129395,6791.129395,29510409856.0,6560.256312857136,50.57389422631161,423992874956.0,0.39362673803371484,0.1456650362987572
1335,1338,2020-04-06,6788.049805,7271.78125,6782.889648,7271.78125,7271.78125,46896904615.0,6621.361049214279,57.146333739898004,470889779571.0,0.42841504789553037,0.06950854145121134
1336,1339,2020-04-07,7273.644043000001,7427.939453,7136.714355,7176.414551000002,7176.414551000002,44243482668.0,6652.9046806428505,55.56748064915393,426646296903.0,0.3783261569010491,0.04348902803374785
1337,1340,2020-04-08,7179.283203,7356.223633,7153.305664,7334.098633,7334.098633,37563249549.0,6699.550083857136,57.650884578362025,464209546452.0,0.4159005481507941,0.0550342388664653
1338,1341,2020-04-09,7337.966309,7341.448242,7179.094238,7302.089355,7302.089355,34815139178.0,6741.382149928564,57.065929996481216,429394407274.0,0.45738731738491756,0.15097963359496397
1339,1342,2020-04-10,7303.81543,7303.81543,6802.475098000001,6865.493164,6865.493164,43622840992.0,6769.646065928565,49.66397565866307,385771566282.0,0.4113596541394335,0.07796188937696291
1340,1343,2020-04-11,6867.44043,6926.069823999998,6789.920898,6859.083008,6859.083008,31222085946.0,6813.709577357136,49.562328663365705,354549480336.0,0.4026914668407724,0.0925483756212923
1341,1344,2020-04-12,6858.067870999998,7119.947265999999,6811.078125,6971.091797,6971.091797,35759567632.0,6888.641636499994,51.43285498500883,390309047968.0,0.33353344746989705,0.013567642018928787
1342,1345,2020-04-13,6965.616698999998,6965.616698999998,6668.259765999999,6845.037598000001,6845.037598000001,38619308647.0,6918.298479428565,49.22054922256311,351689739321.0,0.34117835589956913,0.08289528234573183
1343,1346,2020-04-14,6843.281738,6958.557129000002,6793.821289,6842.427734000001,6842.427734000001,34110434052.0,6947.140136785708,49.173388559964806,317579305269.0,0.3198769189915023,0.07398578721159364
1344,1347,2020-04-15,6845.561523,6928.664551000002,6633.402832,6642.1098630000015,6642.1098630000015,32288311031.0,6949.663957928565,45.564707256641896,285290994238.0,0.43143850586771504,0.0058447678313749835
1345,1348,2020-04-16,6640.4541020000015,7134.450684,6555.504395,7116.804198999998,7116.804198999998,46783242377.0,6972.748221285709,54.15135980272442,332074236615.0,0.3777660656894632,0.10186231762841581
1360,1363,2020-05-01,8672.782227,9048.023438,8667.763672,8864.766602,8864.766602,44068389997.0,7677.430419999995,73.06921801384986,514479246664.0,0.41634468155301485,0.025579990996657663
1361,1364,2020-05-02,8869.057617,9007.1875,8811.366211,8988.59668,8988.59668,40134388683.0,7801.068394357138,74.19435787435799,554613635347.0,0.45728770635113924,0.1167624706691871
1362,1365,2020-05-03,8983.614258,9167.78125,8830.97168,8897.46875,8897.46875,47101785174.0,7923.071533285709,71.81646856435121,507511850173.0,0.3664964306359234,0.04816978254987766
1363,1366,2020-05-04,8895.745117,8956.90625,8645.024414,8912.654297,8912.654297,45718796276.0,8068.1212333571375,71.9776403712185,553230646449.0,0.3831318779294487,0.08024537478484847
1364,1367,2020-05-05,8912.832031,9062.415039,8856.827148,9003.070313,9003.070313,43148462663.0,8219.746024142853,72.96883301476669,596379109112.0,0.3904905912470385,0.07358341041674375
1365,1368,2020-05-06,9007.441406,9411.467773,8966.706055,9268.761719,9268.761719,49371886931.0,8373.428466928566,75.68999975776168,645750996043.0,0.4525820967193644,0.12409587443624902
1366,1369,2020-05-07,9261.895508,9992.664063,9138.322266,9951.518555,9951.518555,61112700562.0,8553.556605928567,80.98684974056587,706863696605.0,0.4520616940476011,0.10063041184644904
1367,1370,2020-05-08,9936.162109,9996.743164,9767.172852,9842.666016,9842.666016,51780748042.0,8717.254115714282,78.06637202688655,655082948563.0,0.3864622797035481,0.10625330510992277
1368,1371,2020-05-09,9840.90625,9913.863281,9580.644531,9593.896484,9593.896484,46566121841.0,8861.822719214282,71.70255975633646,608516826722.0,0.31673408860908864,0.09618303993303993
1369,1372,2020-05-10,9591.168945,9595.581055,8395.107422,8756.430664,8756.430664,63325279337.0,8938.720110357139,55.34593540155639,545191547385.0,0.34459423205902073,0.07219517102615694
1370,1373,2020-05-11,8755.535156,9033.470703,8374.323242,8601.795898,8601.795898,57119858802.0,8996.305454928568,52.944321754577395,488071688583.0,0.45737827872610487,0.04772870487000922
1371,1374,2020-05-12,8610.385742,8949.898438,8569.643555,8804.477539,8804.477539,42142717533.0,9067.549665285711,55.6601575626504,530214406116.0,0.3505333127699831,0.0737966702353799
1372,1375,2020-05-13,8805.387695,9317.878906,8805.387695,9269.987305,9269.987305,45558144023.0,9101.046038071425,61.199161251267405,575772550139.0,0.39677718645491233,0.054731169338928264
1373,1376,2020-05-14,9271.329102,9793.268555,9255.035156,9733.72168,9733.72168,56426907637.0,9177.84375014285,65.78463175316949,632199457776.0,0.3791694719833307,0.0597840876665605
1374,1377,2020-05-15,9734.291016,9755.828125,9261.398438,9328.197266,9328.197266,48158802327.0,9210.945940428566,59.196377920529784,584040655449.0,0.47168960647316566,0.11413639873399725
1375,1378,2020-05-16,9333.240234,9564.205078,9260.694336,9377.013672,9377.013672,36164766408.0,9238.690011285707,59.71934681701829,620205421857.0,0.4898977095701233,0.09198568481327102
1376,1379,2020-05-17,9374.929688,9823.001953,9349.545898,9670.739258,9670.739258,40084250663.0,9293.923618999994,62.808119457565596,660289672520.0,0.3898378311250135,0.06151386306777755
1377,1380,2020-05-18,9675.695313,9906.030273,9570.359375,9726.575195,9726.575195,41827139896.0,9352.060825999997,63.3829365362182,702116812416.0,0.41616239215992906,0.027331602442439904
1378,1381,2020-05-19,9727.063477,9836.047852,9539.624023,9729.038086,9729.038086,39254288955.0,9403.915666928564,63.40980002254764,741371101371.0,0.3876644410483696,0.09195344362978292
1379,1382,2020-05-20,9725.329102,9804.793945,9447.201172,9522.981445,9522.981445,36546239703.0,9422.074218785709,59.478255556439095,704824861668.0,0.420306707331918,0.09854896134572903
1380,1383,2020-05-21,9522.740234,9555.242188,8869.930664,9081.761719,9081.761719,39326160532.0,9359.948730499997,52.038111810930204,665498701136.0,0.4133299341335419,0.08000439137608853
1381,1384,2020-05-22,9080.334961,9232.936523,9008.638672,9182.577148,9182.577148,29810773699.0,9312.799525642851,53.470332100420045,695309474835.0,0.3901185628097393,0.04904087660705308
1382,1385,2020-05-23,9185.0625,9302.501953,9118.108398,9209.287109,9209.287109,27727866812.0,9285.327427428565,53.86342018602114,723037341647.0,0.4308619912905196,0.09341046060794045
1383,1386,2020-05-24,9212.283203,9288.404297,8787.250977,8790.368164,8790.368164,32518803300.0,9287.751534571422,47.13728051079556,690518538347.0,0.4393094867197157,0.07676262084404553
1384,1387,2020-05-25,8786.107422,8951.005859,8719.667969,8906.93457,8906.93457,31288157264.0,9309.54715399999,49.044036256369765,721806695611.0,0.4437814878758523,0.10131753849769942
1385,1388,2020-05-26,8909.585938,8991.967773,8757.293945,8835.052734,8835.052734,29584186947.0,9311.731096499994,47.8967235421496,692222508664.0,0.4296611778226595,0.07740879476960454
1386,1389,2020-05-27,8837.380859,9203.320313,8834.157227,9181.017578,9181.017578,32740536902.0,9305.376115999994,53.53121135892882,724963045566.0,0.44029093646982603,0.07471488300081938
1387,1390,2020-05-28,9184.945313,9546.319336,9148.457031,9525.750977,9525.750977,34367073114.0,9290.521065785708,58.362969968648606,759330118680.0,0.36478445372787477,0.07614999617696985
1388,1391,2020-05-29,9528.355469,9573.666992,9379.338867,9439.124023,9439.124023,32896642044.0,9298.444405571425,56.765678840471104,726433476636.0,0.38993540871753263,0.058621901859740644
1389,1392,2020-05-30,9438.914063,9704.030273,9366.729492,9700.414063,9700.414063,32722975141.0,9321.544433499994,60.29541206860911,759156451777.0,0.3586429794922664,0.10391050082004633
1390,1393,2020-05-31,9700.105469,9700.34375,9432.296875,9461.058594,9461.058594,27773290299.0,9306.56724321428,55.80111956300435,731383161478.0,0.44087577436195513,0.06398554500357675
1391,1394,2020-06-01,9463.605469,10199.56543,9450.899414,10167.268555,10167.268555,35198901068.0,9338.045340357136,64.26462973572838,766582062546.0,0.423180387724707,0.11378380407176646
1392,1395,2020-06-02,10162.973633,10182.34082,9460.571289,9529.803711,9529.803711,39137252109.0,9323.814313571425,54.179503167872504,727444810437.0,0.3231433187573538,0.05309758003617652
1393,1396,2020-06-03,9533.760742,9682.859375,9471.84668,9656.717773,9656.717773,25007459262.0,9333.366908428568,55.67104363009506,752452269699.0,0.37476001130479747,0.058978608178808734
1394,1397,2020-06-04,9655.854492,9887.610352,9525.24707,9800.636719,9800.636719,25921805072.0,9384.71512271428,57.36587130130165,778374074771.0,0.3868062831377932,0.037416040256128734
1395,1398,2020-06-05,9800.21582,9869.237305,9663.216797,9665.533203,9665.533203,23509628646.0,9419.211983785706,55.23108229381008,754864446125.0,0.39177322909914236,0.10021401157773949
1396,1399,2020-06-06,9664.904297,9773.431641,9591.024414,9653.679688,9653.679688,20438419222.0,9450.954310857136,55.03756234540735,734426026903.0,0.4195063228533575,0.09705874170386315
1397,1400,2020-06-07,9653.00293,9768.498047,9458.150391,9758.852539,9758.852539,25015250846.0,9520.13176621428,56.49413181339246,759441277749.0,0.40635678085669696,0.09806520964007548
1398,1401,2020-06-08,9760.063477,9782.306641,9675.885742,9771.489258,9771.489258,21486346312.0,9581.885672499991,56.67573685601985,780927624061.0,0.4216742636872507,0.11109961827494294
1399,1402,2020-06-09,9774.360352,9836.369141,9664.719727,9795.700195,9795.700195,23717842783.0,9650.503348285709,57.04569172384729,804645466844.0,0.3832179969637666,0.07785078118132745
1400,1403,2020-06-10,9794.119141,9908.896484,9728.291016,9870.094727,9870.094727,25706567601.0,9699.72314464285,58.22611173601737,830352034445.0,0.3948662776809931,0.10818039444999702
1401,1404,2020-06-11,9870.078125,9938.297852,9263.069336,9321.78125,9321.78125,30247143440.0,9685.153878428566,47.79984344586385,800104891005.0,0.44011429211722397,0.09946436269806615
1402,1405,2020-06-12,9320.69043,9540.46582,9285.851563,9480.84375,9480.84375,22610564515.0,9688.133858928564,50.56529841027184,822715455520.0,0.37385883873515063,0.033185680764391406
1403,1406,2020-06-13,9480.735352,9493.211914,9396.009766,9475.277344,9475.277344,17564322315.0,9672.05266471428,50.46454195515745,805151133205.0,0.38117990580297656,0.037738291393518926
1404,1407,2020-06-14,9477.553711,9482.270508,9347.59375,9386.788086,9386.788086,18991732746.0,9666.747628428566,48.79983047135511,786159400459.0,0.3535661536319431,0.09067886730715677
1405,1408,2020-06-15,9386.035156,9504.860352,8990.175781,9450.702148,9450.702148,26699704768.0,9615.564313642852,50.080719501857345,812859105227.0,0.39746969653758923,0.05806090429794945
1406,1409,2020-06-16,9454.266602,9579.430664,9400.445313,9538.024414,9538.024414,21565537209.0,9616.15150671428,51.852961197467,834424642436.0,0.3490301741681052,0.054209268381682184
1407,1410,2020-06-17,9533.78418,9540.422852,9327.339844,9480.254883,9480.254883,20177709879.0,9603.547014571424,50.57376130153824,814246932557.0,0.4511755640227085,0.15415491757037109
1408,1411,2020-06-18,9481.567383,9482.782227,9328.395508,9411.84082,9411.84082,17770083003.0,9575.775878928569,49.03110988768627,796476849554.0,0.49378285378784614,0.13096272757319863
1409,1412,2020-06-19,9410.293945,9440.875977,9274.295898,9288.018555,9288.018555,19632223107.0,9548.810546928566,46.27960532175311,776844626447.0,0.4522465974398502,0.0887790328351003
1410,1413,2020-06-20,9290.959961,9394.97168,9247.379883,9332.34082,9332.34082,17130541557.0,9525.857770642851,47.4171039986745,793975168004.0,0.41265523654536135,0.08109280762672648
1411,1414,2020-06-21,9330.926758,9401.107422,9300.430664,9303.629883,9303.629883,15324301169.0,9493.341866642852,46.726882290750474,778650866835.0,0.4351282407398479,0.06967985083610084
1412,1415,2020-06-22,9300.915039,9655.073242,9296.87207,9648.717773,9648.717773,21104009514.0,9484.572474857141,55.17305187276765,799754876349.0,0.35296307838144425,0.04207035237792358
1413,1416,2020-06-23,9644.076172,9670.541016,9547.24707,9629.658203,9629.658203,17006433272.0,9472.712332571424,54.65762094974525,782748443077.0,0.44032448152465326,0.11684343446632406
1414,1417,2020-06-24,9632.149414,9680.367188,9278.233398,9313.610352,9313.610352,18961716076.0,9432.963448642851,46.84292793144621,763786727001.0,0.366891087052546,0.08812336094019926
1415,1418,2020-06-25,9314.126953,9340.161133,9095.324219,9264.813477,9264.813477,18616048626.0,9428.894321999996,45.755187212003634,745170678375.0,0.4244498542198655,0.0950294735995701
1416,1419,2020-06-26,9260.995117,9310.516602,9101.738281,9162.917969,9162.917969,18341465837.0,9406.185337642852,43.48446903189683,726829212538.0,0.43281217839699987,0.09246380058433629
1417,1420,2020-06-27,9167.824219,9207.810547,8998.216797,9045.390625,9045.390625,17273093144.0,9375.479143428569,40.95955445024294,709556119394.0,0.3935334186100398,0.05113492917558796
1418,1421,2020-06-28,9048.460938,9197.546875,8975.525391,9143.582031,9143.582031,14560870760.0,9358.107282357138,43.890887462841384,724116990154.0,0.4362321229403264,0.10608269874235605
1419,1422,2020-06-29,9140.029297,9237.573242,9041.875977,9190.854492,9190.854492,16460547078.0,9339.546735499996,45.29897740032385,740577537232.0,0.3879119142774385,0.08856078795948848
1420,1423,2020-06-30,9185.581055,9217.835938,9084.837891,9137.993164,9137.993164,15735797744.0,9310.973074785708,43.970147302085934,724841739488.0,0.3920556376540064,0.07637374964015
1421,1424,2020-07-01,9145.985352,9309.754883,9104.735352,9228.325195,9228.325195,15971550355.0,9292.978097071424,46.83996748129365,740813289843.0,0.42879076158765395,0.09319434094392473
1422,1425,2020-07-02,9231.139648,9274.962891,9036.623047,9123.410156,9123.410156,16338916796.0,9272.37590678571,44.019866984339245,724474373047.0,0.4046292121822064,0.09001441565167455
1423,1426,2020-07-03,9124.842773,9202.344727,9058.794922,9087.303711,9087.303711,13078970999.0,9258.03913221428,43.0590425556734,711395402048.0,0.4185527518493351,0.08756411813558741
1424,1427,2020-07-04,9084.233398,9183.295898,9053.629883,9132.488281,9132.488281,12290528515.0,9243.763950857141,44.686161182982026,723685930563.0,0.43748959809064336,0.10876797104366792
1425,1428,2020-07-05,9126.09082,9162.183594,8977.015625,9073.942383,9073.942383,12903406143.0,9227.357700857141,42.97268549044522,710782524420.0,0.40128752546676394,0.11187962772912485
1426,1429,2020-07-06,9072.849609,9375.474609,9058.664063,9375.474609,9375.474609,17889263252.0,9207.840331999998,52.97414813255178,728671787672.0,0.41971426721794375,0.12185638489630087
1427,1430,2020-07-07,9349.161133,9360.617188,9201.81543,9252.277344,9252.277344,13839652595.0,9180.884556357141,49.179133253612356,714832135077.0,0.4392779143255335,0.08986017289588719
1428,1431,2020-07-08,9253.020508,9450.335938,9249.5,9428.333008,9428.333008,19702359883.0,9189.07903178571,54.22579220562,734534494960.0,0.3984505716175359,0.10890760930537716
1429,1432,2020-07-09,9427.994141,9431.378906,9234.999023,9277.967773,9277.967773,18000702524.0,9190.01862435714,49.68751245908845,716533792436.0,0.377558432475273,0.061544405237174624
1430,1433,2020-07-10,9273.357422,9287.47168,9118.001953,9278.807617,9278.807617,16860035605.0,9198.29645635714,49.712827488985816,733393828041.0,0.35950942452750234,0.058741228015141055
1431,1434,2020-07-11,9277.511719,9293.532227,9199.485352,9240.34668,9240.34668,13249910444.0,9212.221888857137,48.50909022795353,720143917597.0,0.41658254974460185,0.12037405738101456
1432,1435,2020-07-12,9241.054688,9319.418945,9197.450195,9276.5,9276.5,14452361907.0,9221.716029499994,49.74103098278636,734596279504.0,0.44084720415944156,0.06459526518940911
1433,1436,2020-07-13,9277.205078,9306.405273,9224.292969,9243.614258,9243.614258,17519821266.0,9225.48458421428,48.60194360866826,717076458238.0,0.3860273448626933,0.08654777082431211
1434,1437,2020-07-14,9238.703125,9283.841797,9171.661133,9243.213867,9243.213867,18085038362.0,9233.00034871428,48.58735456399927,698991419876.0,0.4049827777658096,0.059437921096021425
1435,1438,2020-07-15,9241.897461,9275.325195,9171.933594,9192.836914,9192.836914,15844731575.0,9230.465471499994,46.688400391147034,683146688301.0,0.41254560473321356,0.07551504115874519
1436,1439,2020-07-16,9191.980469,9214.3125,9088.947266,9132.227539,9132.227539,15713967523.0,9231.095284571422,44.43810587081618,667432720778.0,0.3900247601715812,0.06916422523238257
1437,1440,2020-07-17,9131.8125,9182.253906,9089.202148,9151.392578,9151.392578,13944570749.0,9235.673060785708,45.3353111768883,681377291527.0,0.42869864810330915,0.06611080416758383
1438,1441,2020-07-18,9151.183594,9230.983398,9100.824219,9159.040039,9159.040039,12252601475.0,9237.569614928565,45.71202424491097,693629893002.0,0.36457486287362456,0.034294443215882854
1439,1442,2020-07-19,9158.005859,9201.398438,9097.632813,9185.817383,9185.817383,12939002784.0,9245.560686357136,47.08701870356905,706568895786.0,0.4055521134949706,0.04725475027617885
1440,1443,2020-07-20,9187.220703,9214.270508,9137.509766,9164.231445,9164.231445,13755604146.0,9230.471888928565,46.073945530756795,692813291640.0,0.4049098414255269,0.08788986340958464
1441,1444,2020-07-21,9162.514648,9407.262695,9149.389648,9374.887695,9374.887695,18069581956.0,9239.229771142851,56.01873221019705,710882873596.0,0.40209452726692274,0.11729822897279113
1442,1445,2020-07-22,9375.080078,9530.518555,9319.65332,9525.363281,9525.363281,16532254884.0,9246.160504928564,61.48293038654225,727415128480.0,0.46212862349460676,0.12561085310562417
1443,1446,2020-07-23,9527.141602,9610.24707,9483.003906,9581.072266,9581.072266,18146399002.0,9267.810825857136,63.30078584522445,745561527482.0,0.4077925555669823,0.04358891389744137
1444,1447,2020-07-24,9585.514648,9623.336914,9481.454102,9536.892578,9536.892578,16552768325.0,9286.245465928565,60.84813643006496,729008759157.0,0.4153001180274539,0.06948546723426798
1445,1448,2020-07-25,9539.485352,9704.556641,9530.211914,9677.113281,9677.113281,16610070933.0,9317.443080285708,65.42681299858793,745618830090.0,0.3981190164215374,0.034179128754759
1446,1449,2020-07-26,9680.234375,10023.807617,9652.847656,9905.166992,9905.166992,20507998997.0,9362.347865428566,71.30455117843813,766126829087.0,0.39963380719809294,0.11223307195450052
1447,1450,2020-07-27,9905.217773,11298.22168,9903.969727,10990.873047,10990.873047,35359749590.0,9487.15206464285,84.66817882526642,801486578677.0,0.4010328386307285,0.12980055952854655
1448,1451,2020-07-28,11017.463867,11204.327148,10632.631836,10912.823242,10912.823242,28766551142.0,9606.40987714285,81.72176772141364,772720027535.0,0.3915982959968901,0.08147942621170516
1449,1452,2020-07-29,10912.953125,11304.397461,10856.141602,11100.467773,11100.467773,24617249715.0,9742.669224214284,83.23250862497119,797337277250.0,0.39458870125276374,0.0809686673882446
1450,1453,2020-07-30,11099.833008,11169.356445,10895.455078,11111.213867,11111.213867,22857247901.0,9884.0253905,83.31754703126556,820194525151.0,0.4132566038679681,0.07990729842228542
1451,1454,2020-07-31,11110.210938,11415.864258,10987.053711,11323.466797,11323.466797,23160469766.0,10039.173549,84.94198282794495,843354994917.0,0.4112161548880281,0.09547343108011058
1452,1455,2020-08-01,11322.570313,11794.775391,11239.682617,11759.592773,11759.592773,26075670303.0,10224.927315714289,87.61135634162541,869430665220.0,0.4103316680422659,0.07984813156202906
1453,1456,2020-08-02,11758.764648,12034.144531,11018.129883,11053.614258,11053.614258,27410067336.0,10358.341378214289,66.92826903123535,842020597884.0,0.38918670391045723,0.06666267609752798
1454,1457,2020-08-03,11043.768555,11453.079102,11012.415039,11246.348633,11246.348633,20271713443.0,10507.0640345,69.07472003844539,862292311327.0,0.4672565110379816,0.09142719316631083
1455,1458,2020-08-04,11246.203125,11385.381836,11094.145508,11205.892578,11205.892578,21250197042.0,10637.850097571429,68.07594706886815,841042114285.0,0.35915496688469156,0.06593317180091733
1456,1459,2020-08-05,11203.823242,11786.617188,11158.285156,11747.022461,11747.022461,24411254471.0,10796.540038999998,73.57895677222184,865453368756.0,0.4108311484744228,0.07974960768845793
1457,1460,2020-08-06,11749.871094,11902.335938,11598.713867,11779.773438,11779.773438,23400740340.0,10953.590122714284,73.87251034233012,888854109096.0,0.37004557001469873,0.086574082210276
1458,1461,2020-08-07,11778.894531,11898.038086,11408.59375,11601.472656,11601.472656,23132312867.0,11101.060128285713,69.35470997782247,865721796229.0,0.3815562866806668,0.08460341009663118
1459,1462,2020-08-08,11604.553711,11800.064453,11558.431641,11754.045898,11754.045898,17572057837.0,11249.412458071429,70.98966828887119,883293854066.0,0.3665042423333702,0.11612547795065913
1460,1463,2020-08-09,11737.325195,11806.056641,11548.78418,11675.739258,11675.739258,17489608833.0,11375.881905642851,68.95627384952365,865804245233.0,0.36842268438170866,0.06084994215853591
1461,1464,2020-08-10,11662.256836,12045.140625,11662.256836,11878.111328,11878.111328,26114112569.0,11439.256068571423,71.24833476538943,891918357802.0,0.40405026427338003,0.11046808218109627
1462,1465,2020-08-11,11881.647461,11932.710938,11195.708984,11410.525391,11410.525391,27039782640.0,11474.806222071424,60.190377022277715,864878575162.0,0.39032261094176396,0.10782539310024687
1463,1466,2020-08-12,11404.59668,11748.396484,11249.605469,11584.93457,11584.93457,25064548486.0,11509.41099328571,62.52660807944182,889943123648.0,0.4462386757955365,0.1015611903610574
1464,1467,2020-08-13,11588.405273,11796.396484,11216.87207,11784.137695,11784.137695,27522199497.0,11557.476980999994,65.04946732055275,917465323145.0,0.4455486845415348,0.10726400001508711
1465,1468,2020-08-14,11772.65918,12150.994141,11685.455078,11768.871094,11768.871094,24237958589.0,11589.291573642851,64.69001757887804,893227364556.0,0.40406394499807724,0.08449343555648381
1466,1469,2020-08-15,11768.697266,11963.203125,11768.697266,11865.698242,11865.698242,23354924400.0,11596.870535714279,65.97424423418903,916582288956.0,0.4179890998475729,0.09414385430254239
1467,1470,2020-08-16,11866.685547,11934.901367,11737.188477,11892.803711,11892.803711,20583375490.0,11656.812639499998,66.34327325826402,937165664446.0,0.361701122310682,0.08020538157756203
1468,1471,2020-08-17,11895.658203,12359.056641,11806.696289,12254.402344,12254.402344,28227687027.0,11728.816475999998,70.8805064360207,965393351473.0,0.4383397084372893,0.09653142738268596
1469,1472,2020-08-18,12251.895508,12335.707031,11954.525391,11991.233398,11991.233398,26043227672.0,11784.912248857143,64.10694818965585,939350123801.0,0.430964943305356,0.07190466060927893
1470,1473,2020-08-19,11990.884766,12028.923828,11687.333008,11758.283203,11758.283203,24502851117.0,11785.716587571429,58.754592158555745,914847272684.0,0.40115759551797553,0.11884384124241583
1471,1474,2020-08-20,11761.5,11900.411133,11710.063477,11878.37207,11878.37207,20175242945.0,11792.759347,60.58169176964637,935022515629.0,0.3165391374282716,0.09784847399664474
1472,1475,2020-08-21,11878.026367,11899.259766,11564.979492,11592.489258,11592.489258,23762425999.0,11792.117675714284,54.40321817665062,911260089630.0,0.37876575527646955,0.04330879847665563
1473,1476,2020-08-22,11585.477539,11689.407227,11448.805664,11681.825195,11681.825195,20224191306.0,11786.959054071429,55.91622676257451,931484280936.0,0.36482729704651345,0.0613183073168467
1474,1477,2020-08-23,11679.696289,11713.429688,11559.920898,11664.847656,11664.847656,18482062658.0,11786.181082500001,55.53905522531382,913002218278.0,0.40519471471185187,0.042732306977168635
1475,1478,2020-08-24,11663.689453,11807.631836,11623.25,11774.595703,11774.595703,20681511755.0,11778.787109285713,57.533202866360675,933683730033.0,0.3891387342562309,0.062095205388770176
1476,1479,2020-08-25,11773.588867,11778.299805,11189.850586,11366.134766,11366.134766,26301509932.0,11775.61635035714,48.76646006105008,907382220101.0,0.41060957547033233,0.1380358360609371
1477,1480,2020-08-26,11366.894531,11530.052734,11296.993164,11488.363281,11488.363281,22466660958.0,11768.718401142856,51.16452963186742,929848881059.0,0.4313245235074561,0.06973362348865612
1478,1481,2020-08-27,11485.608398,11570.786133,11185.941406,11323.397461,11323.397461,23240415076.0,11735.808384428567,47.9054255180837,906608465983.0,0.3931150109281219,0.08998878318808287
1479,1482,2020-08-28,11325.295898,11545.615234,11316.422852,11542.5,11542.5,19807127588.0,11719.639020571423,52.25544518319257,926415593571.0,0.4059312076106652,0.05638798135567737
1480,1483,2020-08-29,11541.054688,11585.640625,11466.292969,11506.865234,11506.865234,17485597759.0,11694.008091428566,51.502201149478005,908929995812.0,0.37827240501253406,0.07035525277984829
1481,1484,2020-08-30,11508.713867,11715.264648,11492.381836,11711.505859,11711.505859,19760127945.0,11681.05824485714,55.47176049378082,928690123757.0,0.37950719772725267,0.10709107427808945
1482,1485,2020-08-31,11713.306641,11768.876953,11598.318359,11680.820313,11680.820313,22285928250.0,11640.088099785713,54.74813100931029,906404195507.0,0.4130789701362446,-0.011953484863952276
1483,1486,2020-09-01,11679.316406,12067.081055,11601.128906,11970.478516,11970.478516,27311555343.0,11638.60560821428,60.04643100865788,933715750850.0,0.4327021112968139,0.092930470805314
1484,1487,2020-09-02,11964.823242,11964.823242,11290.793945,11414.03418,11414.03418,28037405299.0,11614.016392285708,48.3377704332368,905678345551.0,0.4429523127390926,0.08685202114520033
1485,1488,2020-09-03,11407.191406,11443.022461,10182.464844,10245.296875,10245.296875,31927261555.0,11497.36816407142,33.543152419282706,873751083996.0,0.39641336523524373,0.08026567317752628
1486,1489,2020-09-04,10230.365234,10663.919922,10207.94043,10511.813477,10511.813477,29965130374.0,11420.177036857136,38.18909948045092,903716214370.0,0.4137416258500178,0.05874083399228735
1487,1490,2020-09-05,10512.530273,10581.571289,9946.675781,10169.567383,10169.567383,44916565292.0,11312.158621714278,34.82248634647081,858799649078.0,0.43806273528067236,0.14222275913405677
1488,1491,2020-09-06,10167.216797,10353.927734,10056.885742,10280.351563,10280.351563,37071460174.0,11213.266043642849,36.76574292604752,895871109252.0,0.46647620478766544,0.0907154505093295
1489,1492,2020-09-07,10280.998047,10399.15332,9916.493164,10369.563477,10369.563477,33703098409.0,11112.906598928565,38.35952210028235,929574207661.0,0.41893822919367385,0.06659578063933781
1490,1493,2020-09-08,10369.306641,10414.775391,9945.110352,10131.516602,10131.516602,33430927462.0,11024.719587214275,35.76889134269301,896143280199.0,0.3915049051514856,0.08714337738479644
1491,1494,2020-09-09,10134.151367,10350.542969,10017.250977,10242.347656,10242.347656,24128292755.0,10935.718471142847,37.87266361122721,920271572954.0,0.44578086541722567,0.07848691127188956
1492,1495,2020-09-10,10242.330078,10503.912109,10238.135742,10363.138672,10363.138672,54406443211.0,10867.128557642847,40.172576883191795,974678016165.0,0.3905532035928108,0.027458206069366997
1493,1496,2020-09-11,10369.02832,10434.922852,10140.836914,10400.915039,10400.915039,45201121775.0,10785.586774714277,40.909323122990244,1019879137940.0,0.43480100987281356,0.02988726177284101
1494,1497,2020-09-12,10409.861328,10578.837891,10292.386719,10442.170898,10442.170898,36750077324.0,10709.537179285704,41.75293331578167,1056629215264.0,0.38892589340760597,0.07473283049124808
1495,1498,2020-09-13,10452.399414,10577.214844,10224.330078,10323.755859,10323.755859,36506852789.0,10610.412179285704,39.98827185462088,1020122362475.0,0.5059822279708374,0.05175125543303047
1496,1499,2020-09-14,10328.734375,10800.010742,10266.008789,10680.837891,10680.837891,35453581940.0,10538.984863428559,47.23095465223337,1055575944415.0,0.42711581870744736,0.07397347409663772
1497,1500,2020-09-15,10677.754883,10938.631836,10656.459961,10796.951172,10796.951172,32509451925.0,10455.161481714274,49.370708257920676,1088085396340.0,0.42392115344739106,0.0798978103936127
1498,1501,2020-09-16,10797.761719,11100.124023,10704.884766,10974.905273,10974.905273,30769986455.0,10423.795131214278,52.54657917364311,1118855382795.0,0.3993360221545564,0.11537057329947556
1499,1502,2020-09-17,10973.251953,11037.420898,10774.62793,10948.990234,10948.990234,38151810523.0,10474.058942571419,52.03468233568936,1080703572272.0,0.425444051528779,0.08459999045299799
1500,1503,2020-09-18,10951.820313,11034.908203,10829.657227,10944.585938,10944.585938,26341903912.0,10504.97126121428,51.942070483209456,1054361668360.0,0.4308053460009322,0.1064977253073045
1501,1504,2020-09-19,10933.75293,11134.092773,10909.618164,11094.34668,11094.34668,22764204008.0,10571.026925285709,54.88258952776381,1077125872368.0,0.43055921206156583,0.12407712741699002
1502,1505,2020-09-20,11095.870117,11095.870117,10814.477539,10938.271484,10938.271484,24699523788.0,10618.021205357134,51.35587989458398,1052426348580.0,0.4706113065479841,0.05797437663761677
1503,1506,2020-09-21,10934.925781,10988.304688,10380.260742,10462.259766,10462.259766,28884999244.0,10624.642368857136,42.40576772853572,1023541349336.0,0.42991722737064997,0.07545006575621796
1504,1507,2020-09-22,10459.624023,10568.077148,10382.726563,10538.459961,10538.459961,23621787804.0,10653.709751642851,44.085672004326746,1047163137140.0,0.45036576678800505,0.11076085600485985
1505,1508,2020-09-23,10539.457031,10637.847656,10185.774414,10225.864258,10225.864258,22986733997.0,10652.53236607142,39.05327796777118,1024176403143.0,0.4196608165009371,0.10238330007735495
1506,1509,2020-09-24,10227.479492,10765.794922,10215.205078,10745.548828,10745.548828,23017536742.0,10679.847377214277,49.39538050706014,1047193939885.0,0.4381464799113271,0.10800036791596201
1507,1510,2020-09-25,10747.472656,10757.548828,10594.047852,10702.290039,10702.290039,21232549821.0,10701.374162928565,48.65525149682315,1025961390064.0,0.4297302465685921,0.07654550874460167
1508,1511,2020-09-26,10702.237305,10778.5,10682.082031,10754.4375,10754.4375,18105012128.0,10723.678920214275,49.634953121644294,1044066402192.0,0.4088924530122194,0.06178435022724505
1509,1512,2020-09-27,10752.939453,10804.732422,10643.458008,10774.426758,10774.426758,18016880214.0,10755.869698714276,50.02856465035925,1062083282406.0,0.4241197072681957,0.10614514487496793
1510,1513,2020-09-28,10771.641602,10949.123047,10716.676758,10721.327148,10721.327148,22720365389.0,10758.76178849999,48.934524448063094,1039362917017.0,0.5113663204611479,0.0690774694654005
1511,1514,2020-09-29,10712.462891,10858.939453,10665.344727,10848.830078,10848.830078,20459870042.0,10762.467424642848,51.66769219917621,1059822787059.0,0.39102188424308243,0.10259352918799924
1512,1515,2020-09-30,10845.411133,10856.52832,10689.670898,10787.618164,10787.618164,20759622010.0,10749.089773999991,50.27644611122361,1039063165049.0,0.4404098387908384,0.15651758337192156
1513,1516,2020-10-01,10785.010742,10915.84375,10493.552734,10623.330078,10623.330078,27178227816.0,10725.828334285705,46.64604576113536,1011884937233.0,0.38242404782896344,0.09595012189955983
1514,1517,2020-10-02,10624.390625,10662.813477,10440.311523,10585.164063,10585.164063,23127839259.0,10700.155343214274,45.81832361594193,988757097974.0,0.43301299903381946,0.0991456019405766
1515,1518,2020-10-03,10583.806641,10614.091797,10527.978516,10565.493164,10565.493164,17094010304.0,10662.380092071417,45.37145024385457,971663087670.0,0.35793426495147757,0.039024432638069005
1516,1519,2020-10-04,10567.919922,10700.791016,10531.342773,10684.428711,10684.428711,17546792792.0,10644.24846542856,48.633548200485066,989209880462.0,0.3676736263521978,0.11704000032571461
1517,1520,2020-10-05,10688.03418,10804.000977,10646.443359,10804.000977,10804.000977,19385191766.0,10668.658551928558,51.7528167012231,1008595072228.0,0.4212932865340642,0.09686843285183976
1518,1521,2020-10-06,10799.77832,10803.456055,10565.197266,10621.664063,10621.664063,22264958686.0,10674.601702071415,47.0598000623723,986330113542.0,0.4391819136803713,0.1065294024606294
1519,1522,2020-10-07,10619.803711,10687.268555,10591.963867,10679.136719,10679.136719,17634388529.0,10706.978306428558,48.640714714864295,1003964502071.0,0.39287750372776414,0.08101827888703789
1520,1523,2020-10-08,10677.625,10939.799805,10569.823242,10923.62793,10923.62793,21962121001.0,10719.6982422857,54.82147077389296,1025926623072.0,0.44443450495323994,0.11711834577814242
1539,1542,2020-10-27,13075.242188,13759.668945,13060.837891,13654.21875,13654.21875,33749878156.0,12309.75969592856,81.83608793489779,1249453569507.0,0.4416204704565393,0.0879400148499085
1540,1543,2020-10-28,13654.214844,13837.695313,12932.250977,13271.285156,13271.285156,35867318895.0,12441.315290214276,71.05579835698384,1213586250612.0,0.4448127777345506,0.12213343516418915
1541,1544,2020-10-29,13271.298828,13612.047852000003,12980.05957,13437.882813,13437.882813,56499499598.0,12580.067661928559,72.73834783325354,1270085750210.0,0.3778466682118797,0.04598769365794388
1542,1545,2020-10-30,13437.874022999997,13651.516602000003,13136.198242,13546.522461000002,13546.522461000002,30581485201.0,12738.953334357131,73.80761317118902,1300667235411.0,0.4181848985393658,0.09842201015023407
1543,1546,2020-10-31,13546.532227000003,14028.213867,13457.530272999997,13780.995117,13780.995117,30306464719.0,12912.017159642846,75.99591400965943,1330973700130.0,0.3862408240027483,0.06423923094855064
1544,1547,2020-11-01,13780.995117,13862.033203,13628.37793,13737.109375,13737.109375,24453857900.0,13072.99930249999,74.73732075021047,1306519842230.0,0.4104395804442675,0.1020048382378795
1545,1548,2020-11-02,13737.032227000003,13808.323242,13243.160156,13550.489258,13550.489258,30771455468.0,13202.17445599999,69.4686200759723,1275748386762.0,0.3939188878955391,0.07392807953140772
1546,1549,2020-11-03,13550.451172,13984.981445,13325.441406,13950.300781,13950.300781,29869951617.0,13347.45772885713,73.73978051875166,1305618338379.0,0.4144936131684074,0.0698928416644009
1547,1550,2020-11-04,13950.488281,14218.766602000003,13580.47168,14133.707031,14133.707031,35116364962.0,13441.03041299999,75.4373157091978,1340734703341.0,0.4016690414627389,0.07160549161389498
1548,1551,2020-11-05,14133.733397999997,15706.404297,14102.088867,15579.848633,15579.848633,40856321439.0,13627.741629499993,84.14196371264481,1381591024780.0,0.3977245257856866,0.11617376858857545
1549,1552,2020-11-06,15579.729492,15903.4375,15226.839844,15565.880859,15565.880859,39837841971.0,13815.90890064285,83.83294046660981,1341753182809.0,0.41007376510212645,0.06018968875597005
1550,1553,2020-11-07,15565.880859,15737.095703,14423.203125,14833.753906,14833.753906,35024953706.0,13939.17257249999,69.43773323821338,1306728229103.0,0.38776357609986717,0.05605270817781909
1551,1554,2020-11-08,14833.753906,15637.320313,14744.110352000003,15479.567383,15479.567383,26632075029.0,14114.057826428565,73.72390386268697,1333360304132.0,0.3421468511747782,0.04693362373771313
1552,1555,2020-11-09,15479.595703,15785.136719,14865.529297,15332.31543,15332.31543,34149115566.0,14275.276925214275,71.26960804727182,1299211188566.0,0.35765037388163146,0.06734349418530854
1553,1556,2020-11-10,15332.350586000002,15450.329102000003,15124.959961000002,15290.902344,15290.902344,25574938143.0,14392.182896214275,70.55818618858937,1273636250423.0,0.4633423109881605,0.13795310878563588
1554,1557,2020-11-11,15290.90918,15916.260742,15290.006836000002,15701.339844,15701.339844,29772374934.0,14565.758231071419,73.39293114219443,1303408625357.0,0.38801459435254987,0.07026199613663749
1555,1558,2020-11-12,15701.298828,16305.003906,15534.771484,16276.34375,16276.34375,34175758344.0,14768.505440857134,76.76774103530227,1337584383701.0,0.38878635012563595,0.10271327449898877
1556,1559,2020-11-13,16276.44043,16463.177734,15992.152344,16317.808594,16317.808594,31599492172.0,14966.454450357134,76.99435187353609,1369183875873.0,0.43617745783948114,0.08867042893364277
1557,1560,2020-11-14,16317.808594,16317.808594,15749.193359,16068.138672,16068.138672,27481710135.0,15129.821847142846,72.4141606371536,1341702165738.0,0.38260200525965177,0.08879683302235816
1558,1561,2020-11-15,16068.139647999997,16123.110352000003,15793.53418,15955.587891,15955.587891,23653867583.0,15288.284598285703,70.3815666140498,1318048298155.0,0.35813319718252706,0.08884677898246732
1559,1562,2020-11-16,15955.577147999997,16816.181641,15880.706055,16716.111328,16716.111328,31526766675.0,15514.400460428562,75.40521222826976,1349575064830.0,0.46008478317068063,0.06206638569153955
1560,1563,2020-11-17,16685.691406,17782.919922,16564.544922,17645.40625,17645.40625,39006849170.0,15778.336565357136,79.89297908113736,1388581914000.0,0.39371628604751796,0.09968146897649467
1561,1564,2020-11-18,17645.191406,18393.949219,17352.90625,17804.005859,17804.005859,49064800278.0,16040.500767357134,80.54542160973926,1437646714278.0,0.43947957297745244,0.15122884759090116
1562,1565,2020-11-19,17803.861328,18119.546875,17382.554688,17817.089844,17817.089844,36985055355.0,16200.30371099999,80.60134439248287,1474631769633.0,0.4542292918833857,0.1206884937287634
1563,1566,2020-11-20,17817.083984,18773.226563,17765.794922,18621.314453,18621.314453,36992873940.0,16418.548967714276,83.70241832745191,1511624643573.0,0.34974656288942,0.08916153003653005
1564,1567,2020-11-21,18621.316406,18936.621094,18444.359375,18642.232422,18642.232422,39650210707.0,16690.583147428562,83.7750707565851,1551274854280.0,0.4019307431594923,0.10449160864370954
1565,1568,2020-11-22,18642.232422,18688.96875,17671.384766,18370.001953,18370.001953,41280434226.0,16897.042759571417,78.84873932157498,1509994420054.0,0.4229367643513178,0.07919385374853431
1566,1569,2020-11-23,18370.017578,18711.425781,18000.796875,18364.121094,18364.121094,42741112308.0,17113.600306999993,78.74101876911416,1467253307746.0,0.43502239393745473,0.06642142382173594
1567,1570,2020-11-24,18365.015625,19348.271484,18128.65625,19107.464844,19107.464844,51469565009.0,17386.21191414285,82.07456920694503,1518722872755.0,0.41499167210334925,0.10482088584555305
1568,1571,2020-11-25,19104.410156,19390.964844,18581.146484,18732.121094,18732.121094,43710357371.0,17602.69628914285,75.62604754302299,1475012515384.0,0.42216290724848665,0.10160017700179426
1569,1572,2020-11-26,18729.839844,18866.285156,16351.035156,17150.623047,17150.623047,61396835737.0,17665.144810357135,55.750318795445615,1413615679647.0,0.4406469387437764,0.11533133422183581
1570,1573,2020-11-27,17153.914063,17445.023438,16526.423828,17108.402344,17108.402344,38886494645.0,17721.615792499993,55.332227337952645,1374729185002.0,0.4598737149557598,0.1170646717801008
1571,1574,2020-11-28,17112.933594,17853.939453,16910.652344,17717.414063,17717.414063,32601040734.0,17839.421177571418,59.99287387231221,1407330225736.0,0.40083833765747984,0.11217786591140627
1572,1575,2020-11-29,17719.634766,18283.628906,17559.117188,18177.484375,18177.484375,31133957704.0,17998.128069285707,63.12319172776412,1438464183440.0,0.4832737327684137,0.1864328313530441
1573,1576,2020-11-30,18178.322266,19749.263672,18178.322266,19625.835938,19625.835938,47728480399.0,18205.965541428566,70.8545572522933,1486192663839.0,0.3969750825306382,0.04752809433364988
1574,1577,2020-12-01,19633.769531,19845.974609,18321.921875,18802.998047,18802.998047,49633658712.0,18288.650669785708,62.79924669205489,1436559005127.0,0.36942285103329336,0.0913382303564903
1575,1578,2020-12-02,18801.744141,19308.330078,18347.71875,19201.091797,19201.091797,37387697139.0,18388.442522499994,64.87956660814703,1473946702266.0,0.3860268497925433,0.09425336141754233
1576,1579,2020-12-03,19205.925781,19566.191406,18925.785156,19445.398438,19445.398438,31930317405.0,18504.75027921428,66.1312991064745,1505877019671.0,0.41364462485700576,0.08172426652009247
1577,1580,2020-12-04,19446.966797,19511.404297,18697.193359,18699.765625,18699.765625,33872388058.0,18510.353934357136,59.19666824665008,1472004631613.0,0.4234570798451198,0.08715480400112588
1578,1581,2020-12-05,18698.384766,19160.449219,18590.193359,19154.230469,19154.230469,27242455064.0,18546.925223428563,61.82429301605581,1499247086677.0,0.4473963289309285,0.0757361512941784
1579,1582,2020-12-06,19154.179688,19390.5,18897.894531,19345.121094,19345.121094,25293775714.0,18616.57659064285,62.90486491144994,1524540862391.0,0.39549184810681454,0.06144622692314496
1580,1583,2020-12-07,19343.128906,19411.828125,18931.142578,19191.630859,19191.630859,26896357742.0,18675.68443099999,61.399938210163924,1497644504649.0,0.41213337962135654,0.11673685403561218
1581,1584,2020-12-08,19191.529297,19283.478516,18269.945313,18321.144531,18321.144531,31692288756.0,18619.51869435713,53.57219702364233,1465952215893.0,0.42434979935269757,0.10200144904680286
1582,1585,2020-12-09,18320.884766,18626.292969,17935.546875,18553.916016,18553.916016,34420373071.0,18606.789760214277,55.21634377003297,1500372588964.0,0.3701231771813583,0.06477818385835694
1583,1586,2020-12-10,18553.298828,18553.298828,17957.064453,18264.992188,18264.992188,25547132265.0,18686.387555999987,52.7207039227521,1474825456699.0,0.41063333548931014,0.09711377394387201
1584,1587,2020-12-11,18263.929688,18268.453125,17619.533203,18058.904297,18058.904297,27919640985.0,18754.28055264285,50.95170808450445,1446905815714.0,0.3925356911431527,0.12702900747140694
1585,1588,2020-12-12,18051.320313,18919.550781,18046.041016,18803.65625,18803.65625,21752580802.0,18831.8692802857,56.61684721777194,1468658396516.0,0.49660410978792335,0.07071963076120288
1586,1589,2020-12-13,18806.765625,19381.535156,18734.332031,19142.382813,19142.382813,25450468637.0,18900.7905972857,58.93974764968439,1494108865153.0,0.4040027473542584,0.10409297500611353
1587,1590,2020-12-14,19144.492188,19305.099609,19012.708984,19246.644531,19246.644531,22473997681.0,18873.7054967857,59.65580991905424,1516582862834.0,0.4539588661650214,0.1190027515599151
1588,1591,2020-12-15,19246.919922,19525.007813,19079.841797,19417.076172,19417.076172,26741982541.0,18917.568219999983,60.85748736210166,1543324845375.0,0.4496113091120404,0.10255660292782869
1589,1592,2020-12-16,19418.818359,21458.908203,19298.316406,21310.597656,21310.597656,44409011479.0,19068.24720992856,71.14189726063583,1587733856854.0,0.43392711639867765,0.11599889763989255
1590,1593,2020-12-17,21308.351563,23642.660156,21234.675781,22805.162109,22805.162109,71378606374.0,19308.2303292857,76.41033196226677,1659112463228.0,0.4215928883480793,0.11631494619178383
1591,1594,2020-12-18,22806.796875,23238.601563,22399.8125,23137.960938,23137.960938,40387896275.0,19625.244280214272,77.39974797073681,1699500359503.0,0.394716463537691,0.09751557769809835
1592,1595,2020-12-19,23132.865234,24085.855469,22826.472656,23869.832031,23869.832031,38487546580.0,19962.072963214272,79.44185506837556,1737987906083.0,0.40940091516218663,0.03172536000456397
1593,1596,2020-12-20,23861.765625,24209.660156,23147.710938,23477.294922,23477.294922,37844228422.0,20257.228236642844,75.50135976023397,1700143677661.0,0.3439220536699529,0.08803665172362651
1594,1597,2020-12-21,23474.455078,24059.982422,22159.367188,22803.082031,22803.082031,45852713981.0,20515.189034642844,69.15632025570041,1654290963680.0,0.3896993692278587,0.07522275807752682
1595,1598,2020-12-22,22794.039063,23789.902344,22430.605469,23783.029297,23783.029297,44171632681.0,20905.323660785703,72.74194442607535,1698462596361.0,0.462421963025653,0.15271330858101118
1596,1599,2020-12-23,23781.974609,24024.490234,22802.646484,23241.345703,23241.345703,51146161904.0,21240.140066999997,68.03378789405555,1647316434457.0,0.3812379410978368,0.07823338139897519
1597,1600,2020-12-24,23240.203125,23768.337891,22777.597656,23735.949219,23735.949219,41080759713.0,21630.922712071417,69.94653162736634,1688397194170.0,0.4811896891089665,0.07941272219650457
1598,1601,2020-12-25,23733.570313,24710.101563,23463.673828,24664.791016,24664.791016,42068395846.0,22102.77176342856,73.1908128402446,1730465590016.0,0.4161073302521451,0.07733255524041542
1599,1602,2020-12-26,24677.015625,26718.070313,24522.689453,26437.037109,26437.037109,48332647295.0,22648.013253357134,78.05789925885514,1778798237311.0,0.44165605630699184,0.11442812229239614
1600,1603,2020-12-27,26439.373047,28288.839844,25922.769531,26272.294922,26272.294922,66479895605.0,23157.292689714282,76.66459570927573,1712318341706.0,0.36646855439564463,0.07135268782372141
1601,1604,2020-12-28,26280.822266,27389.111327999995,26207.640625,27084.808594,27084.808594,49056742893.0,23717.161551357134,78.68536748571888,1761375084599.0,0.4278047007803059,0.057247993576975464
1602,1605,2020-12-29,27081.810547000005,27370.720702999995,25987.298828,27362.4375,27362.4375,45265946774.0,24284.687360499996,79.3435940211681,1806641031373.0,0.403831909554756,0.10811912359507961
1603,1606,2020-12-30,27360.089844,28937.740234,27360.089844,28840.953125,28840.953125,51287442704.0,24822.569893999997,82.45159475116644,1857928474077.0,0.3784613750139896,0.07348452906900221
1604,1607,2020-12-31,28841.574219,29244.876952999995,28201.992188,29001.720702999995,29001.720702999995,46754964848.0,25265.181222142848,82.75542848666255,1904683438925.0,0.3955211559413496,0.10516808255531787
1605,1608,2021-01-01,28994.009766000006,29600.626952999995,28803.585938,29374.152344,29374.152344,40730301359.0,25710.623465428558,83.4694612359888,1945413740284.0,0.42478863151143853,0.0826944912787018
1606,1609,2021-01-02,29376.455077999995,33155.117188,29091.181641000006,32127.267577999995,32127.267577999995,67865420765.0,26300.440290214272,87.5675754515421,2013279161049.0,0.42325750210201135,0.08337344029259791
1607,1610,2021-01-03,32129.408202999995,34608.558594,32052.316406,32782.023438,32782.023438,78665235202.0,26965.063755642852,88.30983754812931,2091944396251.0,0.44234101799751874,0.12085321045252828
1608,1611,2021-01-04,32810.949219,33440.21875,28722.755859,31971.914063,31971.914063,81163475344.0,27619.980329357135,81.80231066961882,2010780920907.0,0.3850300648499733,0.08209982412766005
1609,1612,2021-01-05,31977.041016000006,34437.589844,30221.1875,33992.429688,33992.429688,67547324782.0,28349.223214428563,84.80904583340288,2078328245689.0,0.4196812316554381,0.05171269882988566
1610,1613,2021-01-06,34013.613281,36879.699219,33514.035156,36824.363281,36824.363281,75289433811.0,29319.438755714284,87.84133356912079,2153617679500.0,0.34851093384265225,0.06916444144745237
1611,1614,2021-01-07,36833.875,40180.367188,36491.191406,39371.042969,39371.042969,84762141031.0,30436.231166428566,89.81100067481006,2238379820531.0,0.4087312634189075,0.05898046795663996
1612,1615,2021-01-08,39381.765625,41946.738281,36838.636719,40797.609375,40797.609375,88107519480.0,31588.57533492856,90.71808341042656,2326487340011.0,0.426775244567524,0.09739278596539627
1613,1616,2021-01-09,40788.640625,41436.351563,38980.875,40254.546875,40254.546875,61984162837.0,32575.540318214284,87.52372483670129,2264503177174.0,0.408780995184269,0.08222047358505692
1614,1617,2021-01-10,40254.21875,41420.191406,35984.628906,38356.441406,38356.441406,79980747690.0,33438.693638499986,77.2809534515582,2184522429484.0,0.3999435437629309,0.06336961666211458
1615,1618,2021-01-11,38346.53125,38346.53125,30549.599609,35566.65625,35566.65625,123320567399.0,34044.53989964285,65.20297615876697,2061201862085.0,0.41127079716511794,0.04568289058897881
1616,1619,2021-01-12,35516.359375,36568.527344,32697.976563,33922.960938,33922.960938,74773277909.0,34513.14871664285,59.32048021872834,1986428584176.0,0.4188499810090821,0.0974455368115205
1617,1620,2021-01-13,33915.121094,37599.960938,32584.667969,37316.359375,37316.359375,69364315979.0,35118.53487735714,66.11683979757534,2055792900155.0,0.4052130285936525,0.08040529165286144
1618,1621,2021-01-14,37325.109375,39966.40625,36868.5625,39187.328125,39187.328125,63615990033.0,35846.078264642856,69.1747421340265,2119408890188.0,0.4313915292987696,0.10748813933595153
1619,1622,2021-01-15,39156.707031,39577.710938,34659.589844,36825.367188,36825.367188,67760757881.0,36378.30789635714,61.61484443930091,2051648132307.0,0.4009496484121255,0.037514356157132354
1620,1623,2021-01-16,36821.648438,37864.367188,35633.554688,36178.140625,36178.140625,57706187875.0,36667.65597114286,59.68981700795975,1993941944432.0,0.3994730778750036,0.07733647606525222
1621,1624,2021-01-17,36163.648438,36722.351563,34069.320313,35791.277344,35791.277344,52359854336.0,36882.6026787143,58.51305085062332,1941582090096.0,0.3669031378790151,0.09944886381773638
1622,1625,2021-01-18,35792.238281,37299.285156,34883.84375,36630.074219,36630.074219,49511702429.0,37215.32840414286,60.338794542988126,1991093792525.0,0.39511427945860245,0.10443052144832472
1623,1626,2021-01-19,36642.234375,37755.890625,36069.804688,36069.804688,36069.804688,57244195486.0,37363.71233271428,58.48733169046577,1933849597039.0,0.40310204469083855,0.050579297610332995
1624,1627,2021-01-20,36050.113281,36378.328125,33570.476563,35547.75,35547.75,66834573161.0,37272.52566978572,56.740249670484886,1867015023878.0,0.41346473523004584,0.04461106168229242
1625,1628,2021-01-21,35549.398438,35552.679688,30250.75,30825.699219,30825.699219,75643067688.0,36662.143973357146,43.95158126502191,1791371956190.0,0.37918555149331,0.10560917403040172
1626,1629,2021-01-22,30817.625,33811.851563,28953.373047000005,33005.761719,33005.761719,77207272511.0,36105.583426500016,49.599540517544135,1868579228701.0,0.3663237506541078,0.04249626440028226
1627,1630,2021-01-23,32985.757813,33360.976563,31493.160156,32067.642577999995,32067.642577999995,48354737975.0,35520.80454814286,47.38665970767217,1820224490726.0,0.4368882440275938,0.060227589023004825
1628,1631,2021-01-24,32064.376952999995,32944.007813,31106.685547000005,32289.378906,32289.378906,48643830599.0,35087.442941000016,47.977452949061956,1868868321325.0,0.4435814051282357,0.0730566116470081
1629,1632,2021-01-25,32285.798827999995,34802.742188,32087.787109,32366.392577999995,32366.392577999995,59897054838.0,34858.852678714284,48.195036808557006,1928765376163.0,0.4275536984670049,0.059126336085509476
1630,1633,2021-01-26,32358.613281,32794.550781,31030.265625,32569.849609,32569.849609,60255421470.0,34762.2018695,48.80423507056613,1989020797633.0,0.38841404452128675,0.08357802697358553
1631,1634,2021-01-27,32564.029297000005,32564.029297000005,29367.138672000005,30432.546875,30432.546875,62576762015.0,34270.50097664286,43.07390598084484,1926444035618.0,0.4293980773969605,0.1186249365778758
1632,1635,2021-01-28,30441.041016000006,31891.300781,30023.207031,31649.605469,31649.605469,78948162368.0,33732.0922155,46.897462033653476,2005392197986.0,0.40182832045966427,0.09092249771376856
1633,1636,2021-01-29,34318.671875,38406.261719,32064.814452999995,34316.386719,34316.386719,117894572511.0,33552.879324857146,54.16249565695143,2123286770497.0,0.40129912488284575,0.05933680942006859
1634,1637,2021-01-30,34295.933594,34834.707031,32940.1875,34269.523438,34269.523438,65141828798.0,33416.54952578572,54.02262455012149,2058144941699.0,0.4333520760064878,0.08604384904384904
1635,1638,2021-01-31,34270.878906,34288.332031,32270.175781,33114.359375,33114.359375,52754542671.0,33225.341099428566,50.556814863700936,2005390399028.0,0.3829340538297486,0.0879288582391063
1636,1639,2021-02-01,33114.578125,34638.214844,32384.228516000006,33537.175781,33537.175781,61400400660.0,33004.41978242857,51.77631614057472,2066790799688.0,0.457532619341602,0.12831509281356143
1637,1640,2021-02-02,33533.199219,35896.882813,33489.21875,35510.289063,35510.289063,63088585433.0,32964.45438064286,57.094612350837174,2129879385121.0,0.451280498081658,0.08725932559857061
1638,1641,2021-02-03,35510.820313,37480.1875,35443.984375,37472.089844,37472.089844,61166818159.0,33101.90722664286,61.626051884370106,2191046203280.0,0.42881491415525613,0.09771558193772698
1639,1642,2021-02-04,37475.105469,38592.175781,36317.5,36926.066406,36926.066406,68838074392.0,33537.64774,59.73503862786593,2122208128888.0,0.3831291166123733,0.08395095222392829
1640,1643,2021-02-05,36931.546875,38225.90625,36658.761719,38144.308594,38144.308594,58598066402.0,33904.6868025,62.49987821816821,2180806195290.0,0.4170349397452787,0.10030386121408566
1641,1644,2021-02-06,38138.386719,40846.546875,38138.386719,39266.011719,39266.011719,71326033653.0,34418.856026857145,64.8904247740805,2252132228943.0,0.4098836887346739,0.09490522582905123
1642,1645,2021-02-07,39250.191406,39621.835938,37446.152344,38903.441406,38903.441406,65500641143.0,34891.289062571435,63.48174468211786,2186631587800.0,0.3960519586106198,0.10263721600744909
1643,1646,2021-02-08,38886.828125,46203.929688,38076.324219,46196.464844,46196.464844,101467222687.0,35879.15136728572,75.16192861827305,2288098810487.0,0.3784112366663575,0.1112328042086117
1644,1647,2021-02-09,46184.992188,48003.722656,45166.960938,46481.105469,46481.105469,91809846886.0,36872.81250014286,75.49141079933935,2379908657373.0,0.3830529289023726,0.06943026003566079
1645,1648,2021-02-10,46469.761719,47145.566406,43881.152344,44918.183594,44918.183594,87301089896.0,37907.500837214284,70.00054825918133,2292607567477.0,0.45000847982855563,0.07689836483355085
1646,1649,2021-02-11,44898.710938,48463.46875,44187.761719,47909.332031,47909.332031,81388911810.0,39068.909877357146,73.91146132603464,2373996479287.0,0.4604159110203522,0.07501341853072915
1647,1650,2021-02-12,47877.035156,48745.734375,46424.976563,47504.851563,47504.851563,76555041196.0,40010.9430805,72.53440044019118,2297441438091.0,0.44056654017232305,0.11021777114159777
1648,1651,2021-02-13,47491.203125,48047.746094,46392.28125,47105.515625,47105.515625,70250456155.0,40927.79966528572,71.12546212519277,2227190981936.0,0.4330247134275611,0.14111079717405162
1649,1652,2021-02-14,47114.507813,49487.640625,47114.507813,48717.289063,48717.289063,71248675228.0,42042.294643,73.37354150328153,2298439657164.0,0.36408349641092697,0.09993081368876518
1650,1653,2021-02-15,48696.535156,48875.570313,46347.476563,47945.058594,47945.058594,77069903166.0,43071.429129642864,70.53981119896744,2221369753998.0,0.4145741489420683,0.08940352338488275
1651,1654,2021-02-16,47944.457031,50341.101563,47201.304688,49199.871094,49199.871094,77049582886.0,44049.256417571436,72.40477159131139,2298419336884.0,0.39305796045667457,0.06758504864008907
1652,1655,2021-02-17,49207.277344,52533.914063,49072.378906,52149.007813,52149.007813,80820545404.0,45097.607701071436,76.2156578309458,2379239882288.0,0.4276434995098691,0.06527805158901771
1653,1656,2021-02-18,52140.972656,52474.105469,51015.765625,51679.796875,51679.796875,52054723579.0,46151.4455917143,74.45393512183708,2327185158709.0,0.4480020748303385,0.10154331816690018
1654,1657,2021-02-19,51675.980469,56113.65234400001,50937.277344,55888.132813,55888.132813,63495496918.0,47418.86160735716,79.11648863828201,2390680655627.0,0.3955094711210588,0.10890741514256294
1655,1658,2021-02-20,55887.335938,57505.226563,54626.55859400001,56099.51953099999,56099.51953099999,68145460026.0,48621.25502250001,79.32065704193397,2458826115653.0,0.4240324779638527,0.013777381964100166
1656,1659,2021-02-21,56068.56640599999,58330.570313,55672.609375,57539.945313,57539.945313,51897585191.0,49952.43387300001,80.70495232721552,2510723700844.0,0.3709424414556217,0.02297667482744013
1657,1660,2021-02-22,57532.73828099999,57533.390625,48967.566406,54207.320313,54207.320313,92052420332.0,50524.63783507144,69.16831033447541,2418671280512.0,0.45198037452028766,0.16088197978769725
1658,1661,2021-02-23,54204.929688,54204.929688,45290.589844,48824.425781,48824.425781,106102492824.0,50692.01785735715,55.39435052581053,2312568787688.0,0.43968726032179023,0.09440388238101201
1659,1662,2021-02-24,48835.085938,51290.136719,47213.5,49705.332031,49705.332031,63695521388.0,51033.95703142857,56.90672604547669,2376264309076.0,0.4220187949798339,0.05429310417612556
1660,1663,2021-02-25,49709.082031,51948.96875,47093.851563,47093.851563,47093.851563,54506565949.0,50975.708426571415,51.3484641743361,2321757743127.0,0.4090257876228677,0.07812376480761654
1661,1664,2021-02-26,47180.464844,48370.785156,44454.84375,46339.761719,46339.761719,350967941479.0,50892.48772342857,49.8348014056236,1970789801648.0,0.4212739218269812,0.09312187716400734
1662,1665,2021-02-27,46344.773438,48253.269531,45269.027344,46188.453125,46188.453125,45910946382.0,50826.98325914285,49.519372138269546,1924878855266.0,0.42743481134155265,0.044532726656350864
1663,1666,2021-02-28,46194.015625,46716.429688,43241.617188,45137.769531,45137.769531,53443887451.0,50571.303292571436,47.281410106179536,1871434967815.0,0.44310123181216926,0.08153025793650794
1664,1667,2021-03-01,45159.503906,49784.015625,45115.09375,49631.242188,49631.242188,53891300112.0,50691.74497785714,56.364132400468385,1925326267927.0,0.4224952796042569,0.0974088994172736
1665,1668,2021-03-02,49612.105469,50127.511719,47228.84375,48378.988281,48378.988281,47530897720.0,50633.11049121427,53.59301202452508,1877795370207.0,0.38592534412252943,0.10185250525162932
1666,1669,2021-03-03,48415.816406,52535.136719,48274.320313,50538.242188,50538.242188,53220811975.0,50518.05580371427,57.47531703081524,1931016182182.0,0.4861087829967439,0.05465196525824407
1667,1670,2021-03-04,50522.304688,51735.089844,47656.929688,48561.167969,48561.167969,52343816680.0,50295.29659614285,53.09538857975063,1878672365502.0,0.4621074747951613,0.10328622207300506
1668,1671,2021-03-05,48527.03125,49396.429688,46542.515625,48927.304688,48927.304688,48625928883.0,49798.09458721428,53.7975797474955,1927298294385.0,0.40169840145816565,0.09045378285191716
1669,1672,2021-03-06,48899.230469,49147.21875,47257.527344,48912.382813,48912.382813,34363564661.0,49284.72767878569,53.76225475403579,1892934729724.0,0.44245004912534125,0.11139895531476987
1670,1673,2021-03-07,48918.679688,51384.367188,48918.679688,51206.691406,51206.691406,43137459378.0,48832.352399714284,58.296499701283004,1936072189102.0,0.44512221426766246,0.05551266620289954
1671,1674,2021-03-08,51174.117188,52314.070313,49506.054688,52246.523438,52246.523438,48597428048.0,48692.295480071436,60.20139965877953,1984669617150.0,0.47935666133576893,0.11272938323374093
1672,1675,2021-03-09,52272.96875,54824.117188,51981.832031,54824.117188,54824.117188,50912227385.0,49120.84486628572,64.52688595806211,2035581844535.0,0.37958153794544897,0.06254936727665457
1673,1676,2021-03-10,54824.01171900001,57258.25390599999,53290.890625,56008.55078099999,56008.55078099999,57295577614.0,49571.074777,66.33737559407854,2092877422149.0,0.38857458923474886,0.0776112443730932
1674,1677,2021-03-11,55963.179688,58091.0625,54484.59375,57805.12109400001,57805.12109400001,56772343595.0,50336.165457785726,68.92788806144081,2149649765744.0,0.4274252459026691,0.10631883440530006
1675,1678,2021-03-12,57821.21875,57996.62109400001,55376.648438,57332.08984400001,57332.08984400001,55689944702.0,51121.33175242858,67.45595417993937,2093959821042.0,0.4399052710576262,0.06942713288431115
1676,1679,2021-03-13,57343.37109400001,61683.86328099999,56217.97265599999,61243.085938,61243.085938,60669829814.0,52196.66266764287,72.65530022060307,2154629650856.0,0.4732720959595959,0.09976364337822673
1677,1680,2021-03-14,61221.132813,61597.91796900001,59302.31640599999,59302.31640599999,59302.31640599999,43901225564.0,53208.41601585715,66.94005933463131,2110728425292.0,0.44027139751760597,0.08892431820948149
1678,1681,2021-03-15,59267.429688,60540.992188,55393.164063,55907.19921900001,55907.19921900001,66419369890.0,53656.69866092858,58.3002676106697,2044309055402.0,0.452346141092772,0.13642702511485377
1679,1682,2021-03-16,55840.78515599999,56833.179688,53555.027344,56804.90234400001,56804.90234400001,59749798599.0,54258.54966542858,59.77848483424596,2104058854001.0,0.4155121974090271,0.08635998378523213
1680,1683,2021-03-17,56825.828125,58969.81640599999,54528.62890599999,58870.89453099999,58870.89453099999,60258313191.0,54853.73911850001,63.026899639026674,2164317167192.0,0.45338805041954316,0.12119977256405957
1681,1684,2021-03-18,58893.078125,60116.25,54253.578125,57858.921875,57858.921875,55746041000.0,55517.86439750001,60.451498339428504,2108571126192.0,0.4391676066137058,0.08983576346103984
1682,1685,2021-03-19,57850.44140599999,59498.375,56643.703125,58346.65234400001,58346.65234400001,49063873786.0,56190.674944357146,61.27285214311472,2157634999978.0,0.4194457624319924,0.08070859830716591
1683,1686,2021-03-20,58332.26171900001,60031.28515599999,58213.296875,58313.64453099999,58313.64453099999,50361731222.0,56862.19363850001,61.18024744638479,2107273268756.0,0.38417683675447645,0.008360047304852505
1684,1687,2021-03-21,58309.914063,58767.898438,56005.617188,57523.421875,57523.421875,51943414539.0,57313.38867200002,58.885724779746454,2055329854217.0,0.4247075355713254,0.06697142683052347
1685,1688,2021-03-22,57517.890625,58471.48046900001,54288.15625,54529.14453099999,54529.14453099999,56521454974.0,57476.43303578573,51.069922682323295,1998808399243.0,0.38893996400024944,0.10601185276963879
1686,1689,2021-03-23,54511.66015599999,55985.44140599999,53470.695313,54738.945313,54738.945313,56435023914.0,57470.34933042857,51.55511201852032,2055243423157.0,0.38339978839473665,0.07292453639457867
1687,1690,2021-03-24,54710.48828099999,57262.382813,52514.332031,52774.265625,52774.265625,70567223787.0,57239.32896214287,46.86823772883098,1984676199370.0,0.42818030257841183,0.11571940055185853
1688,1691,2021-03-25,52726.746094,53392.386719,50856.570313,51704.160156,51704.160156,67999812841.0,56803.54603800002,44.495513291620185,1916676386529.0,0.41475502803007985,0.09427702933807659
1689,1692,2021-03-26,51683.011719,55137.3125,51579.855469,55137.3125,55137.3125,56652197978.0,56646.7762277143,52.75860491714328,1973328584507.0,0.4142182194341806,0.1183663828371709
1690,1693,2021-03-27,55137.56640599999,56568.21484400001,54242.91015599999,55973.51171900001,55973.51171900001,47266542233.0,56270.3780692143,54.534029815438814,2020595126740.0,0.39833455344258917,0.06552195380677525
1691,1694,2021-03-28,55974.94140599999,56610.3125,55071.11328099999,55950.74609400001,55950.74609400001,47686580918.0,56030.98018978573,54.474006026006926,1972908545822.0,0.44535003270901186,0.0944577311669957
1692,1695,2021-03-29,55947.898438,58342.09765599999,55139.33984400001,57750.19921900001,57750.19921900001,57625587027.0,56162.6230469286,58.37401811381579,2030534132849.0,0.43589999790273076,0.1246036008875237
1693,1696,2021-03-30,57750.132813,59447.22265599999,57251.55078099999,58917.69140599999,58917.69140599999,54414116432.0,56313.536551357145,60.72485472149517,2084948249281.0,0.4145822804578959,0.10728755790420923
1694,1697,2021-03-31,58930.27734400001,59930.02734400001,57726.41796900001,58918.83203099999,58918.83203099999,65520826225.0,56316.96065850002,60.727188306019144,2150469075506.0,0.4330576710811039,0.1353375642425008
1695,1698,2021-04-01,58926.5625,59586.070313,58505.27734400001,59095.80859400001,59095.80859400001,61669163792.0,56405.30970985716,61.11325724031351,2212138239298.0,0.40333931502673603,0.09774374449494717
1696,1699,2021-04-02,59098.87890599999,60267.1875,58869.28125,59384.3125,59384.3125,58727860620.0,56479.42829242859,61.77298367722331,2270866099918.0,0.34397436317961533,0.07203535405438574
1697,1700,2021-04-03,59397.41015599999,60110.26953099999,57603.890625,57603.890625,57603.890625,59641344484.0,56428.73158485716,55.513780723457835,2211224755434.0,0.3737246868488228,0.06923317454221832
1698,1701,2021-04-04,57604.83984400001,58913.74609400001,57168.67578099999,58758.554688,58758.554688,50749662970.0,56516.95535721432,58.45392009852498,2261974418404.0,0.42841092608070364,0.12152313752294423
1699,1702,2021-04-05,58760.875,59891.296875,57694.82421900001,59057.87890599999,59057.87890599999,60706272115.0,56840.43638400002,59.20658790978772,2322680690519.0,0.41525410738902124,0.10472807573038297
1700,1703,2021-04-06,59171.93359400001,59479.578125,57646.80859400001,58192.359375,58192.359375,66058027988.0,57087.10881700002,56.04483046157893,2256622662531.0,0.4369048943319979,0.0806450771285281
1701,1704,2021-04-07,58186.507813,58731.14453099999,55604.023438,56048.9375,56048.9375,75645303584.0,57321.01395092859,49.05794901647587,2180977358947.0,0.39921977077313725,0.08945511969053467
1702,1705,2021-04-08,56099.914063,58338.73828099999,55879.085938,58323.953125,58323.953125,53053855641.0,57793.856305857145,55.411699326777665,2234031214588.0,0.4287705536515193,0.09414141364550907
1703,1706,2021-04-09,58326.5625,58937.046875,57807.86328099999,58245.00390599999,58245.00390599999,46655208546.0,58015.83426342857,55.15461022007035,2187376006042.0,0.4169084743640191,0.10485311645686204
1704,1707,2021-04-10,58253.77734400001,61276.664063,58038.70703099999,59793.234375,59793.234375,58238470525.0,58288.67159600001,59.15660481740571,2245614476567.0,0.3830463283670521,0.0664362625272713
1705,1708,2021-04-11,59846.23046900001,60790.554688,59289.796875,60204.96484400001,60204.96484400001,46280252580.0,58592.544363857145,60.174451901156864,2291894729147.0,0.3717228899268373,0.0892911705541942
1706,1709,2021-04-12,60175.945313,61253.03515599999,59589.875,59893.453125,59893.453125,51828688519.0,58745.63392857143,58.976915235871566,2240066040628.0,0.4345415954057312,0.07620234577769613
1707,1710,2021-04-13,59890.01953099999,63742.28515599999,59869.95703099999,63503.45703099999,63503.45703099999,69983454362.0,59073.18861607143,67.13861335309565,2310049494990.0,0.4340752013021982,0.12589455798727295
1708,1711,2021-04-14,63523.75390599999,64863.09765599999,61554.796875,63109.695313,63109.695313,77451779687.0,59372.535993357145,65.6054009992616,2232597715303.0,0.4400224567907172,0.11184316162099515
1709,1712,2021-04-15,63075.195313,63821.671875,62208.96484400001,63314.01171900001,63314.01171900001,60954381579.0,59673.836216571435,66.03877979765863,2293552096882.0,0.4371047822388457,0.12950007025738286
1710,1713,2021-04-16,63258.50390599999,63594.72265599999,60222.53125,61572.789063,61572.789063,84293007468.0,59830.155971071435,59.19355682123847,2209259089414.0,0.4256185779173442,0.12822220994953445
1711,1714,2021-04-17,61529.921875,62572.17578099999,60361.351563,60683.820313,60683.820313,66138759198.0,60050.150948785726,56.00195561368038,2143120330216.0,0.3605420815295816,0.1263925324675325
1712,1715,2021-04-18,60701.88671900001,61057.45703099999,52829.535156,56216.18359400001,56216.18359400001,97468872758.0,59868.55301350001,43.35131540166176,2045651457458.0,0.3958189160458664,0.10552232910411104
1713,1716,2021-04-19,56191.585938,57520.054688,54368.59375,55724.265625,55724.265625,65344865159.0,59630.43777914287,42.22039732462401,1980306592299.0,0.3959225217715014,0.0860396657180516
1714,1717,2021-04-20,55681.79296900001,57062.148438,53448.046875,56473.03125,56473.03125,67849323955.0,59507.628627357146,44.589892107187346,2048155916254.0,0.37644860307477196,0.09564020560751513
1715,1718,2021-04-21,56471.12890599999,56757.97265599999,53695.46875,53906.08984400001,53906.08984400001,54926612466.0,59354.56808050002,38.726555619778345,1993229303788.0,0.38795799213340876,0.09112108616045066
1716,1719,2021-04-22,53857.10546900001,55410.23046900001,50583.8125,51762.273438,51762.273438,74798630778.0,58885.876674285726,34.63085731861341,1918430673010.0,0.420312237919049,0.1063452602973743
1717,1720,2021-04-23,51739.808594,52120.792969,47714.664063,51093.652344,51093.652344,86668667320.0,58375.06584842858,33.442901728219795,1831762005690.0,0.4095442925176638,0.08984451435154346
1718,1721,2021-04-24,51143.226563,51167.5625,48805.285156,50050.867188,50050.867188,49014494781.0,57679.18247792858,31.62105130700071,1782747510909.0,0.41490589846881515,0.107185999679333
1719,1722,2021-04-25,50052.832031,50506.019531,47159.484375,49004.253906,49004.253906,46117114240.0,56879.13169664287,29.862668369601426,1736630396669.0,0.4453082417245212,0.09263710886398037
1720,1723,2021-04-26,49077.792969,54288.00390599999,48852.796875,54021.75390599999,54021.75390599999,58284039825.0,56459.724609571436,45.5071870380656,1794914436494.0,0.3873783195275319,0.07996236032867378
1721,1724,2021-04-27,54030.304688,55416.96484400001,53319.1875,55033.117188,55033.117188,49448222757.0,55854.70033507144,48.02383065891655,1844362659251.0,0.3889964381689098,0.11121558940013754
1722,1725,2021-04-28,55036.63671900001,56227.20703099999,53887.91796900001,54824.703125,54824.703125,48000572955.0,55262.91517878573,47.53662163027172,1796362086296.0,0.4270912855897311,0.09381805232597977
1723,1726,2021-04-29,54858.08984400001,55115.84375,52418.027344,53555.109375,53555.109375,46088929780.0,54565.85072564287,44.57024693294952,1750273156516.0,0.4434754467692516,0.0985654530003246
1724,1727,2021-04-30,53568.664063,57900.71875,53129.601563,57750.17578099999,57750.17578099999,52395931985.0,54292.80691978573,54.642099991178654,1802669088501.0,0.4525294217733149,0.09675057629258867
1725,1728,2021-05-01,57714.664063,58448.33984400001,57052.273438,57828.05078099999,57828.05078099999,42836427360.0,54088.823381785725,54.80626800585486,1845505515861.0,0.4338066845505957,0.07208735719339289
1726,1729,2021-05-02,57825.86328099999,57902.59375,56141.90625,56631.078125,56631.078125,38177405335.0,54118.458705428566,51.70836870356166,1807328110526.0,0.3500661099273828,0.057899390513444046
1727,1730,2021-05-03,56620.273438,58973.30859400001,56590.87109400001,57200.29296900001,57200.29296900001,51713139031.0,54223.88923000001,53.06697093145478,1859041249557.0,0.44853738464952814,0.10914175170288
1728,1731,2021-05-04,57214.179688,57214.179688,53191.425781,53333.539063,53333.539063,68564706967.0,53999.639788071436,44.0092417506305,1790476542590.0,0.37590421711565686,0.09045130893604336
1729,1732,2021-05-05,53252.164063,57911.36328099999,52969.054688,57424.007813,57424.007813,69241316747.0,54250.919642999994,53.12420476536826,1859717859337.0,0.4501778103808838,0.12083921682089824
1730,1733,2021-05-06,57441.30859400001,58363.31640599999,55382.507813,56396.515625,56396.515625,69523285106.0,54581.936942071436,50.883396055024605,1790194574231.0,0.39878930773236965,0.0986351837176441
1731,1734,2021-05-07,56413.953125,58606.632813,55321.84765599999,57356.40234400001,57356.40234400001,68434023376.0,55029.27622778573,52.882876885935964,1858628597607.0,0.43624395361272894,0.12259748870625176
1732,1735,2021-05-08,57352.765625,59464.61328099999,56975.210938,58803.77734400001,58803.77734400001,65382980634.0,55654.484096071435,55.80442769528752,1924011578241.0,0.38299368944839907,0.08124824477380413
1733,1736,2021-05-09,58877.390625,59210.882813,56482.00390599999,58232.31640599999,58232.31640599999,65906690347.0,56313.63141750001,54.37094734383327,1858104887894.0,0.4142163265808737,0.09378403071900097
1734,1737,2021-05-10,58250.87109400001,59519.35546900001,54071.45703099999,55859.796875,55859.796875,71776546298.0,56444.92020100001,48.76974223682971,1786328341596.0,0.4494879331258241,0.13543348667363972
1735,1738,2021-05-11,55847.242188,56872.54296900001,54608.65234400001,56704.57421900001,56704.57421900001,61308396325.0,56564.30998892858,50.71659206296735,1847636737921.0,0.4056479262161315,0.06511755011521844
1736,1739,2021-05-12,56714.53125,57939.36328099999,49150.535156,49150.535156,49150.535156,75215403907.0,56159.01227685716,37.12903856870636,1772421334014.0,0.40296862014931556,0.09800773078260562
1737,1740,2021-05-13,49735.433594,51330.84375,46980.019531,49716.191406,49716.191406,96721152926.0,55884.80385050002,38.4586246159659,1869142486940.0,0.42556578763690045,0.0848635800637369
1738,1741,2021-05-14,49682.980469,51438.117188,48868.578125,49880.535156,49880.535156,55737497453.0,55322.68666300002,38.86315824728976,1924879984393.0,0.3744158733500045,0.051494882965579136
1739,1742,2021-05-15,49855.496094,50639.664063,46664.140625,46760.1875,46760.1875,59161047474.0,54532.125000071435,34.258566821588715,1865718936919.0,0.38760288810108207,0.07148516233186318
1740,1743,2021-05-16,46716.636719,49720.042969,43963.351563,46456.058594,46456.058594,64047871555.0,53805.33789071432,33.837749239921486,1801671065364.0,0.4018437359555781,0.06263300402504947
1741,1744,2021-05-17,46415.898438,46623.558594,42207.289063,43537.511719,43537.511719,74903638450.0,52829.42494428573,30.02606619848632,1726767426914.0,0.40644891514328835,0.09982103634647073
1742,1745,2021-05-18,43488.058594,45812.457031,42367.832031,42909.402344,42909.402344,56187365084.0,52084.843750071464,29.26210009482216,1670580061830.0,0.4080527168764217,0.09125508294942024
1743,1746,2021-05-19,42944.976563,43546.117188,30681.496094,37002.441406,37002.441406,126358098747.0,50626.160435285754,23.266636573086075,1544221963083.0,0.4108282355996327,0.10692773127608975
1744,1747,2021-05-20,36753.667969,42462.984375,35050.617188,40782.738281,40782.738281,88281943359.0,49510.89062500004,32.76136703254687,1632503906442.0,0.40451819173286974,0.10629155626306766
1745,1748,2021-05-21,40596.949219,42172.171875,33616.453125,37304.691406,37304.691406,82051616861.0,48078.62555800002,29.18345749537015,1550452289581.0,0.4327358823441487,0.09598875316168919
1746,1749,2021-05-22,37371.03125,38831.054688,35383.683594,37536.632813,37536.632813,57377273240.0,46559.54380578573,29.734565370954076,1607829562821.0,0.3701383350773762,0.07182165220628545
1747,1750,2021-05-23,37531.449219,38289.21875,31227.339844,34770.582031,34770.582031,78469274361.0,44883.705636142884,27.032733014683245,1529360288460.0,0.4485267454414229,0.09310207427667012
1748,1751,2021-05-24,34700.363281,39835.140625,34551.082031,38705.980469,38705.980469,67359584098.0,43658.43303571432,35.94995333907435,1596719872558.0,0.41301082684801355,0.10195817113766945
1749,1752,2021-05-25,38795.78125,39776.351563,36581.429688,38402.222656,38402.222656,56211915803.0,42351.12220978574,35.58843219295349,1540507956755.0,0.39802739885297206,0.07147932807883425
1750,1753,2021-05-26,38392.625,40782.078125,37905.835938,39294.199219,39294.199219,51346735160.0,41647.098214285754,37.573675803456986,1591854691915.0,0.406245694675397,0.05833395772424988
1751,1754,2021-05-27,39316.890625,40379.617188,37247.902344,38436.96875,38436.96875,43210968721.0,40841.439453142884,36.412159753586465,1548643723194.0,0.42624770526981454,0.11935684972716136
1752,1755,2021-05-28,38507.082031,38856.96875,34779.039063,35697.605469,35697.605469,55200191952.0,39828.37304692862,32.91094610182547,1493443531242.0,0.40589475344142123,0.08441652207532235
1753,1756,2021-05-29,35684.15625,37234.5,33693.929688,34616.066406,34616.066406,45231013335.0,38960.93582592862,31.618276231890587,1448212517907.0,0.4234760814875618,0.05773796686739188
1754,1757,2021-05-30,34607.40625,36400.667969,33520.738281,35678.128906,35678.128906,31646080921.0,38191.08370535717,34.345400714126356,1479858598828.0,0.40844277470351587,0.0560289954108429
1755,1758,2021-05-31,35658.59375,37468.25,34241.945313,37332.855469,37332.855469,39009847639.0,37747.89397321432,38.4631600065859,1518868446467.0,0.3511786538904577,0.0711925274915198
1756,1759,2021-06-01,37293.792969,37896.734375,35787.085938,36684.925781,36684.925781,34639423297.0,37303.2885044286,37.47212177192338,1484229023170.0,0.4106976930185018,0.12030023948625658
1757,1760,2021-06-02,36699.921875,38231.339844,35966.308594,37575.179688,37575.179688,33070867190.0,37344.19838171431,39.76848165743984,1517299890360.0,0.4176955422505635,0.09187205240205572
1758,1761,2021-06-03,37599.410156,39478.953125,37243.972656,39208.765625,39208.765625,35460750427.0,37231.7717634286,43.84393310513882,1552760640787.0,0.3735749368277747,0.0781942687015601
1759,1762,2021-06-04,39242.484375,39242.484375,35717.722656,36894.40625,36894.40625,41831090187.0,37202.46568085717,39.741258929832746,1510929550600.0,0.4101702987924915,0.1084948883914118
1760,1763,2021-06-05,36880.15625,37917.714844,34900.414063,35551.957031,35551.957031,35959473399.0,37060.70312500002,37.54653863324385,1474970077201.0,0.3859494361512354,0.09832983095281983
1761,1764,2021-06-06,35538.609375,36436.421875,35304.578125,35862.378906,35862.378906,28913440585.0,37138.688616071464,38.393768654327424,1503883517786.0,0.41331806530534093,0.11724142040714144
1762,1765,2021-06-07,35835.265625,36790.570313,33480.640625,33560.707031,33560.707031,33683936663.0,36771.16908478575,34.64131786807884,1470199581123.0,0.3785438543046222,0.1113242393930574
1763,1766,2021-06-08,33589.519531,34017.386719,31114.443359,33472.632813,33472.632813,49902050442.0,36419.055524571464,34.5023568164935,1420297530681.0,0.45042501000557705,0.08413268643857223
1764,1767,2021-06-09,33416.976563,37537.371094,32475.865234,37345.121094,37345.121094,53972919008.0,36279.83565850002,44.957355394780905,1474270449689.0,0.3665505266241652,0.08032673999650324
1765,1768,2021-06-10,37389.515625,38334.324219,35847.59375,36702.597656,36702.597656,43576032854.0,36155.952008928594,43.71063527214716,1430694416835.0,0.3970995351192951,0.06870614040544316
1766,1769,2021-06-11,36697.03125,37608.695313,36044.449219,37334.398438,37334.398438,38699736985.0,36272.865792428594,45.316469200200565,1469394153820.0,0.4011075902662051,0.11566320124106723
1767,1770,2021-06-12,37340.144531,37408.925781,34728.191406,35552.515625,35552.515625,37924228550.0,36339.75502235717,41.702993215676045,1431469925270.0,0.4403928402635054,0.035118556281477184
1768,1771,2021-06-13,35555.789063,39322.78125,34864.109375,39097.859375,39097.859375,40669112838.0,36584.0214844286,50.20997238727701,1472139038108.0,0.43646616075337197,0.05714749475568417
1769,1772,2021-06-14,39016.96875,40978.363281,38757.285156,40218.476563,40218.476563,43148914673.0,36790.13727685717,52.56611421386761,1515287952781.0,0.37704338326226544,0.06207648872095177
1770,1773,2021-06-15,40427.167969,41295.269531,39609.46875,40406.269531,40406.269531,46420149185.0,37055.94754471431,52.96777672643035,1561708101966.0,0.39445737899240807,0.10338467911510625
1771,1774,2021-06-16,40168.691406,40516.777344,38176.035156,38347.0625,38347.0625,39211635100.0,37111.08203128573,48.152746375112564,1522496466866.0,0.4230379494592743,0.11411816083894559
1772,1775,2021-06-17,38341.421875,39513.671875,37439.675781,38053.503906,38053.503906,37096670047.0,37028.56333707145,47.48996754590861,1485399796819.0,0.44013072594412417,0.11092241671321505
1773,1776,2021-06-18,38099.476563,38187.261719,35255.855469,35787.246094,35787.246094,36200887275.0,36949.48046878574,42.6136145401678,1449198909544.0,0.4326850728128349,0.1346163990174172
1774,1777,2021-06-19,35854.527344,36457.796875,34933.0625,35615.871094,35615.871094,31207279719.0,36954.04575900003,42.26022966777247,1417991629825.0,0.43176483209618133,0.061036373472757414
1775,1778,2021-06-20,35563.140625,36059.484375,33432.074219,35698.296875,35698.296875,36664034054.0,36942.3256139286,42.50718218780493,1454655663879.0,0.338796031021521,0.06859496102080527
1776,1779,2021-06-21,35641.144531,35721.640625,31295.935547000005,31676.693359,31676.693359,52809038594.0,36807.753208785754,34.707416414193986,1401846625285.0,0.4137034645443961,0.0646027957287559
1777,1780,2021-06-22,31622.376952999995,33292.453125,28893.621094,32505.660156,32505.660156,58964353058.0,36738.683733285754,37.26286130447158,1460810978343.0,0.3887322402621675,0.03345626957493432
1778,1781,2021-06-23,32515.714844,34753.410156,31772.632813,33723.027344,33723.027344,46317108925.0,36479.962751142884,40.91976893327024,1507128087268.0,0.41190574105598254,0.11091152296894742
1779,1782,2021-06-24,33682.800781,35228.851563,32385.214844,34662.4375,34662.4375,33123368116.0,36334.23702571431,43.649413294359725,1540251455384.0,0.41378061299290325,0.12012064210100487
1780,1783,2021-06-25,34659.105469,35487.246094,31350.884766000006,31637.779297000005,31637.779297000005,40230904226.0,35927.33565850002,37.62223293533045,1500020551158.0,0.39520686757705026,0.11689653449558375
1781,1784,2021-06-26,31594.664063,32637.587891000006,30184.501952999995,32186.277344,32186.277344,38585385521.0,35686.89006700001,39.260153850223325,1538605936679.0,0.40913368553913704,0.10292338931207057
1782,1785,2021-06-27,32287.523438,34656.128906,32071.757813,34649.644531,34649.644531,35511640894.0,35369.16043528573,46.10481315869065,1574117577573.0,0.3672033554648074,0.03888722218839697
1783,1786,2021-06-28,34679.121094,35219.890625,33902.074219,34434.335938,34434.335938,33892523752.0,34956.00753350002,45.6209094160976,1540225053821.0,0.4057669515408795,0.09078008420009072
1784,1787,2021-06-29,34475.558594,36542.109375,34252.484375,35867.777344,35867.777344,37901460044.0,34631.829520142885,49.426637948429644,1578126513865.0,0.43102671965029316,0.10272857330774816
1785,1788,2021-06-30,35908.386719,36074.757813,34086.152344,35040.835938,35040.835938,34059036099.0,34395.67048000002,47.367134811816776,1544067477766.0,0.4275377009954219,0.0581410068096906
1786,1789,2021-07-01,35035.984375,35035.984375,32883.78125,33572.117188,33572.117188,37838957079.0,34075.57142871431,43.8707067084833,1506228520687.0,0.3847728165768947,0.09067121891864499
1787,1790,2021-07-02,33549.601563,33939.589844,32770.679688,33897.046875,33897.046875,38728974942.0,33940.55719878574,44.84077229940025,1544957495629.0,0.43406038696985516,0.11554803766076369
1788,1791,2021-07-03,33854.421875,34909.261719,33402.695313,34668.546875,34668.546875,24383958643.0,33872.891183142885,47.175200931320326,1569341454272.0,0.3572119469320192,0.01728673233800943
1789,1792,2021-07-04,34665.566406,35937.566406,34396.476563,35287.78125,35287.78125,24924307911.0,33843.56863850002,49.03943511701888,1594265762183.0,0.45596330530485446,0.1037598591656786
1790,1793,2021-07-05,35284.34375,35284.34375,33213.660156,33746.003906,33746.003906,26721554282.0,33991.37653471431,44.800143387482855,1567544207901.0,0.4320298633430181,0.11374987915687021
1791,1794,2021-07-06,33723.507813,35038.535156,33599.917969,34235.195313,34235.195313,26501259870.0,34114.91476021431,46.38388748870398,1594045467771.0,0.41828602891768424,0.09036236857159584
1792,1795,2021-07-07,34225.679688,34997.664063,33839.289063,33855.328125,33855.328125,24796027477.0,34124.36481600003,45.297074401636564,1569249440294.0,0.3814558997887885,0.10011225903598102
1793,1796,2021-07-08,33889.605469,33907.90625,32133.183594,32877.371094,32877.371094,29910396946.0,33996.86007271431,42.53397588178246,1539339043348.0,0.42372363774162247,0.10154490314522734
1794,1797,2021-07-09,32861.671875,34042.292969,32318.880859,33798.011719,33798.011719,27436021028.0,34151.162388571465,45.88079811471125,1566775064376.0,0.44113469603173233,0.07791895281409793
1795,1798,2021-07-10,33811.242188,34209.070313,33116.011719,33520.519531,33520.519531,22971873468.0,34246.465401928595,45.029534133130944,1543803190908.0,0.41333181385001044,0.0357251314095536
1796,1799,2021-07-11,33509.078125,34584.703125,33346.738281,34240.1875,34240.1875,20108729370.0,34217.218471142885,47.737774986517,1563911920278.0,0.3203206330222819,0.05289569356274935
1797,1800,2021-07-12,34254.015625,34592.15625,32697.308594,33155.847656,33155.847656,24321499537.0,34125.897879571465,44.20401151669164,1539590420741.0,0.4088984285557467,0.08767378374130087
1798,1801,2021-07-13,33125.46875,33327.101563,32261.419922000005,32702.025391000006,32702.025391000006,19120856669.0,33899.77274007145,42.77679897680879,1520469564072.0,0.4412159666483581,0.10012964425036859
1799,1802,2021-07-14,32723.845702999995,33061.398438,31639.125,32822.347656,32822.347656,21376531210.0,33741.30929135717,43.29950642909097,1541846095282.0,0.35225343218426175,0.06750022286016699
1800,1803,2021-07-15,32827.875,33159.640625,31175.708984,31780.730469,31780.730469,21300524237.0,33613.35309714288,39.901511596577,1520545571045.0,0.39010085373902825,0.09038388535469674
1801,1804,2021-07-16,31841.550781,32218.40625,31100.673827999995,31421.539063,31421.539063,23699476918.0,33436.53111057145,38.77157090406033,1496846094127.0,0.4077846339179305,0.0925335796293985
1802,1805,2021-07-17,31397.308594,31935.945313,31223.990234,31533.068359,31533.068359,18895018942.0,33212.568359428595,39.34591749204343,1515741113069.0,0.4295370867213012,0.10700874570968659
1803,1806,2021-07-18,31533.884766000006,32398.996094,31215.492188,31796.810547000005,31796.810547000005,18787986667.0,32963.21330921431,40.76107068648211,1534529099736.0,0.392028044424452,0.05907805553690006
1804,1807,2021-07-19,31800.011719,31885.859375,30563.734375,30817.832031,30817.832031,20434789545.0,32754.058175285736,37.283775624429104,1514094310191.0,0.381386168637642,0.08874484742478908
1805,1808,2021-07-20,30838.285156,31006.1875,29360.955077999995,29807.347656,29807.347656,23148267245.0,32437.78334264288,34.05445599649455,1490946042946.0,0.4053262878631422,0.0936058278849523
1806,1809,2021-07-21,29796.285156,32752.326172000005,29526.183594,32110.693359,32110.693359,28203024559.0,32313.16657364288,45.61733187107804,1519149067505.0,0.3520441824463505,0.07389910967616292
1807,1810,2021-07-22,32138.873047000005,32576.400391000006,31745.298827999995,32313.105469,32313.105469,19555230518.0,32272.86188614288,46.505010100374925,1538704298023.0,0.3843468160408399,0.07023610632410146
1808,1811,2021-07-23,32305.958984,33581.550781,32057.892577999995,33581.550781,33581.550781,22552046192.0,32257.40039057145,51.81316291690747,1561256344215.0,0.3756385453494899,0.06990043677133846
1809,1812,2021-07-24,33593.730469,34490.390625,33424.859375,34292.445313,34292.445313,21664706865.0,32312.53794642859,54.53596689316932,1582921051080.0,0.39479360085982457,0.08408342582475531
1810,1813,2021-07-25,34290.292969,35364.925781,33881.835938,35350.1875,35350.1875,20856685287.0,32391.823660714308,58.3105855836253,1603777736367.0,0.3919404542703154,0.0780188303938304
1811,1814,2021-07-26,35384.03125,40499.675781,35287.3125,37337.535156,37337.535156,51022126212.0,32690.515625000025,64.30670735001897,1654799862579.0,0.4338680737328336,0.10391497320474627
1812,1815,2021-07-27,37276.035156,39406.941406,36441.726563,39406.941406,39406.941406,35097370560.0,33169.43819750002,69.26403962448029,1689897233139.0,0.4294467825023995,0.08358016308119383
1813,1816,2021-07-28,39503.1875,40816.070313,38862.4375,39995.90625,39995.90625,38702404695.0,33681.835239928594,70.51900530152977,1728599637834.0,0.4477102597035101,0.06567706435444047
1814,1817,2021-07-29,39995.453125,40593.070313,39352.058594,40008.421875,40008.421875,27167146027.0,34269.52748321431,70.54652663238075,1755766783861.0,0.4614560744838105,0.11207100496517648
1815,1818,2021-07-30,40027.484375,42235.546875,38397.355469,42235.546875,42235.546875,33072782960.0,35041.95661264288,75.01608424476308,1788839566821.0,0.40053634216712647,0.055637133446824416
1816,1819,2021-07-31,42196.304688,42231.449219,41110.832031,41626.195313,41626.195313,25802845343.0,35762.894252214304,71.80543148726889,1763036721478.0,0.36768164312871554,0.08736343455220522
1817,1820,2021-08-01,41460.84375,42541.679688,39540.941406,39974.894531,39974.894531,26688438115.0,36347.04310821431,63.83240681277014,1736348283363.0,0.41756166823163127,0.06803625545296973
1818,1821,2021-08-02,39907.261719,40419.179688,38746.347656,39201.945313,39201.945313,25595265436.0,36945.908342642884,60.44892495295412,1710753017927.0,0.409490516472661,0.07931916732863278
1819,1822,2021-08-03,39178.402344,39750.03125,37782.050781,38152.980469,38152.980469,26189830450.0,37542.02497214288,56.10280357358098,1684563187477.0,0.40425785395506864,0.067142529284814
1820,1823,2021-08-04,38213.332031,39952.296875,37589.164063,39747.503906,39747.503906,25372562724.0,38087.51143978573,60.725340179661124,1709935750201.0,0.41126318030163145,0.0907536328526136
1821,1824,2021-08-05,39744.515625,41341.933594,37458.003906,40869.554688,40869.554688,35185031017.0,38698.68638400002,63.62788181115835,1745120781218.0,0.4561470567282357,0.09641452440039666
1822,1825,2021-08-06,40865.867188,43271.660156,39932.179688,42816.5,42816.5,38226483046.0,39358.3256139286,68.04135333741452,1783347264264.0,0.38402120694629016,0.1006288413750988
1823,1826,2021-08-07,42783.4375,43901.675781,42684.074219,43515.773438,43515.773438,40215953408.0,40017.13476571431,69.47406461195229,1823563217672.0,0.4774092451918002,0.08593998087626037
